Original Block -> Cipher Block
aaa -> dha
aab -> gxs
aac -> gff
aad -> kzl
aae -> okl
aaf -> tii
aag -> evd
aah -> djr
aai -> cko
aaj -> uuf
aak -> dwv
aal -> nzh
aam -> rtc
aan -> muw
aao -> ktf
aap -> ikc
aaq -> qvn
aar -> rgb
aas -> hli
aat -> cnf
aau -> ltj
aav -> jli
aaw -> jqw
aax -> ixt
aay -> vuh
aaz -> fau
aba -> qtk
abb -> nkt
abc -> vgt
abd -> kqi
abe -> bmo
abf -> gfa
abg -> wyz
abh -> yrx
abi -> nki
abj -> zlg
abk -> grk
abl -> wmu
abm -> kxh
abn -> ils
abo -> lkf
abp -> gvg
abq -> tpq
abr -> ulu
abs -> cux
abt -> kwg
abu -> vey
abv -> ybm
abw -> rdm
abx -> wus
aby -> fzn
abz -> gtr
aca -> hzb
acb -> jqo
acc -> dsk
acd -> smz
ace -> ucw
acf -> lmc
acg -> dyy
ach -> hvi
aci -> vde
acj -> tmf
ack -> ibp
acl -> kqp
acm -> tin
acn -> fql
aco -> gak
acp -> nfa
acq -> hnq
acr -> omj
acs -> ubs
act -> yta
acu -> sjm
acv -> oim
acw -> lcx
acx -> mbf
acy -> xnr
acz -> mey
ada -> ylb
adb -> asl
adc -> phg
add -> hkx
ade -> bbo
adf -> zjv
adg -> boh
adh -> dlv
adi -> ksi
adj -> dik
adk -> hkp
adl -> jyy
adm -> ldq
adn -> wlm
ado -> spz
adp -> ezl
adq -> zwj
adr -> yje
ads -> mmk
adt -> jsz
adu -> sgp
adv -> xqz
adw -> aoe
adx -> fhp
ady -> gdt
adz -> bbg
aea -> qtc
aeb -> rkk
aec -> nrf
aed -> pcs
aee -> yrn
aef -> onk
aeg -> pnq
aeh -> jzx
aei -> fhz
aej -> lkh
aek -> qya
ael -> ctz
aem -> cmz
aen -> fpz
aeo -> nbo
aep -> drc
aeq -> wkp
aer -> nnw
aes -> kfq
aet -> tpl
aeu -> nlb
aev -> afb
aew -> vap
aex -> qmf
aey -> gel
aez -> zww
afa -> gto
afb -> uww
afc -> hfi
afd -> mii
afe -> tkd
aff -> rvu
afg -> mvw
afh -> gzz
afi -> ltl
afj -> nyo
afk -> qis
afl -> mxi
afm -> rey
afn -> kom
afo -> qsn
afp -> hya
afq -> rcb
afr -> lzf
afs -> qzs
aft -> bha
afu -> mxo
afv -> wpb
afw -> iin
afx -> agt
afy -> shv
afz -> vjw
aga -> dhv
agb -> rbv
agc -> tho
agd -> upg
age -> pxv
agf -> ynm
agg -> sgo
agh -> xed
agi -> ygn
agj -> jnr
agk -> klh
agl -> znd
agm -> sxj
agn -> zcz
ago -> jsa
agp -> whj
agq -> nfg
agr -> hxv
ags -> alq
agt -> zxc
agu -> ksy
agv -> nod
agw -> bho
agx -> twu
agy -> wpw
agz -> wzp
aha -> pbt
ahb -> sxt
ahc -> qdh
ahd -> vnu
ahe -> ztq
ahf -> wif
ahg -> pzs
ahh -> zzh
ahi -> ouu
ahj -> nny
ahk -> ijr
ahl -> nnj
ahm -> kja
ahn -> wpl
aho -> wzn
ahp -> fye
ahq -> xsh
ahr -> mgo
ahs -> jge
aht -> ubv
ahu -> pvd
ahv -> ame
ahw -> zgk
ahx -> eur
ahy -> ffd
ahz -> gah
aia -> vgq
aib -> ani
aic -> lts
aid -> blr
aie -> mzv
aif -> jnq
aig -> jvh
aih -> ekz
aii -> jfd
aij -> kyh
aik -> kmv
ail -> cyr
aim -> mam
ain -> daw
aio -> wti
aip -> rmy
aiq -> nga
air -> yvz
ais -> psd
ait -> fiz
aiu -> cvi
aiv -> aug
aiw -> kza
aix -> nla
aiy -> ama
aiz -> abh
aja -> cua
ajb -> bny
ajc -> mgc
ajd -> dmf
aje -> xtj
ajf -> suu
ajg -> tpy
ajh -> edd
aji -> wzm
ajj -> ygp
ajk -> rfa
ajl -> yyl
ajm -> enw
ajn -> sgc
ajo -> bzv
ajp -> flz
ajq -> sdf
ajr -> jru
ajs -> mzi
ajt -> kxw
aju -> glt
ajv -> qnj
ajw -> mvt
ajx -> fsl
ajy -> sez
ajz -> fim
aka -> bke
akb -> ull
akc -> kfs
akd -> pjs
ake -> jaw
akf -> xmf
akg -> yov
akh -> snd
aki -> lnq
akj -> gsb
akk -> ump
akl -> llx
akm -> bpq
akn -> bvf
ako -> wwf
akp -> gbx
akq -> ifa
akr -> gsl
aks -> nww
akt -> dox
aku -> eds
akv -> pkk
akw -> blt
akx -> ecj
aky -> yyx
akz -> mra
ala -> wya
alb -> oyp
alc -> bzx
ald -> jmc
ale -> fwx
alf -> yud
alg -> paq
alh -> fvb
ali -> kmq
alj -> ncn
alk -> cmx
all -> ayf
alm -> pns
aln -> vtm
alo -> isl
alp -> unb
alq -> fdv
alr -> gzh
als -> udl
alt -> its
alu -> xuq
alv -> gdc
alw -> fru
alx -> vcp
aly -> ypg
alz -> prl
ama -> owd
amb -> kmc
amc -> ryw
amd -> ppz
ame -> chd
amf -> smk
amg -> edw
amh -> qjn
ami -> njd
amj -> lnz
amk -> hci
aml -> wat
amm -> iif
amn -> qni
amo -> aac
amp -> ore
amq -> jyo
amr -> tgl
ams -> qzf
amt -> imq
amu -> fht
amv -> kai
amw -> otb
amx -> pey
amy -> rll
amz -> lof
ana -> xpl
anb -> ttj
anc -> xgi
and -> uat
ane -> uvv
anf -> iju
ang -> kxp
anh -> sbx
ani -> qmr
anj -> law
ank -> vxa
anl -> msn
anm -> qol
ann -> jwz
ano -> tgo
anp -> gsi
anq -> oyy
anr -> wvj
ans -> qhe
ant -> oya
anu -> pki
anv -> lnu
anw -> eii
anx -> ppu
any -> bed
anz -> qva
aoa -> tcp
aob -> htc
aoc -> mmo
aod -> ogm
aoe -> amf
aof -> ayk
aog -> vtc
aoh -> fkr
aoi -> uzv
aoj -> pka
aok -> ffy
aol -> yfe
aom -> lbz
aon -> gsd
aoo -> shn
aop -> dyv
aoq -> aiu
aor -> yug
aos -> yxg
aot -> nmq
aou -> mig
aov -> lgx
aow -> rhe
aox -> uhc
aoy -> dqg
aoz -> hqp
apa -> dka
apb -> gva
apc -> xmx
apd -> kpi
ape -> qxl
apf -> eih
apg -> dyt
aph -> jpg
api -> xnx
apj -> mim
apk -> zjq
apl -> tfe
apm -> hcr
apn -> icu
apo -> pkl
app -> gws
apq -> wbl
apr -> dbm
aps -> bww
apt -> vkz
apu -> crw
apv -> onm
apw -> qkt
apx -> ege
apy -> nvt
apz -> hkh
aqa -> zhc
aqb -> yde
aqc -> apa
aqd -> req
aqe -> ktc
aqf -> ekq
aqg -> kdi
aqh -> zij
aqi -> yxu
aqj -> jcu
aqk -> jtt
aql -> pkh
aqm -> rml
aqn -> mnl
aqo -> esy
aqp -> azg
aqq -> ntq
aqr -> upj
aqs -> uvg
aqt -> lgl
aqu -> ccn
aqv -> uyz
aqw -> hgy
aqx -> ejc
aqy -> kya
aqz -> xaj
ara -> efw
arb -> inf
arc -> yzu
ard -> mwj
are -> mwi
arf -> raa
arg -> voe
arh -> kqf
ari -> eeo
arj -> yee
ark -> aqs
arl -> mwk
arm -> twc
arn -> uys
aro -> mbh
arp -> ima
arq -> gfu
arr -> naj
ars -> zrk
art -> uhg
aru -> sjf
arv -> bqx
arw -> fdy
arx -> bkf
ary -> hii
arz -> igv
asa -> ghb
asb -> mss
asc -> ugh
asd -> xxf
ase -> svm
asf -> uxz
asg -> rcv
ash -> hle
asi -> uzq
asj -> hsv
ask -> ohe
asl -> iot
asm -> kov
asn -> eiv
aso -> qix
asp -> psz
asq -> nse
asr -> ier
ass -> bhr
ast -> dag
asu -> snk
asv -> uab
asw -> ero
asx -> thy
asy -> awz
asz -> yem
ata -> xca
atb -> jei
atc -> yzc
atd -> zng
ate -> wek
atf -> dwj
atg -> wwh
ath -> pyt
ati -> clz
atj -> iea
atk -> udw
atl -> ayz
atm -> uho
atn -> hnj
ato -> vhx
atp -> hsl
atq -> sse
atr -> wmt
ats -> tdl
att -> hud
atu -> vjc
atv -> ukb
atw -> cog
atx -> ycq
aty -> wku
atz -> lxf
aua -> itd
aub -> axj
auc -> ssh
aud -> ion
aue -> qhc
auf -> nft
aug -> sis
auh -> zss
aui -> avm
auj -> lvb
auk -> tnu
aul -> bvh
aum -> lne
aun -> pdv
auo -> pfu
aup -> bbz
auq -> mlp
aur -> tsu
aus -> jpr
aut -> mmz
auu -> tsd
auv -> zqw
auw -> fwi
aux -> ylq
auy -> drt
auz -> lda
ava -> bwy
avb -> ktk
avc -> lng
avd -> fxh
ave -> fvz
avf -> nih
avg -> xod
avh -> mwf
avi -> zut
avj -> vos
avk -> qkj
avl -> rrh
avm -> tre
avn -> tkk
avo -> zxb
avp -> otd
avq -> tvg
avr -> ohr
avs -> hzf
avt -> yrc
avu -> psc
avv -> vhw
avw -> qsl
avx -> zon
avy -> jlj
avz -> idk
awa -> yfw
awb -> ede
awc -> eoa
awd -> hgt
awe -> moj
awf -> bgr
awg -> olt
awh -> xjd
awi -> bsl
awj -> msa
awk -> jql
awl -> iay
awm -> hpm
awn -> lvl
awo -> obx
awp -> bee
awq -> qly
awr -> pel
aws -> sjx
awt -> vly
awu -> rcg
awv -> fzc
aww -> fmk
awx -> lpy
awy -> ezg
awz -> mcz
axa -> klv
axb -> rmd
axc -> tev
axd -> dux
axe -> mtn
axf -> zhz
axg -> szf
axh -> zzq
axi -> nyb
axj -> vlr
axk -> lds
axl -> xsu
axm -> yuw
axn -> qab
axo -> myt
axp -> dcg
axq -> pyh
axr -> ieb
axs -> ybk
axt -> qtx
axu -> vli
axv -> mso
axw -> nrl
axx -> bxp
axy -> rgi
axz -> zgm
aya -> pmt
ayb -> mwq
ayc -> rty
ayd -> ssn
aye -> kxd
ayf -> han
ayg -> ufe
ayh -> eiq
ayi -> ass
ayj -> cuy
ayk -> jly
ayl -> lwl
aym -> rfn
ayn -> gzy
ayo -> hba
ayp -> zvb
ayq -> dyh
ayr -> xeo
ays -> cql
ayt -> hit
ayu -> xcr
ayv -> qna
ayw -> jaq
ayx -> axm
ayy -> cfp
ayz -> lhc
aza -> oui
azb -> dxl
azc -> gmj
azd -> vpp
aze -> xux
azf -> spq
azg -> hue
azh -> tcx
azi -> bpy
azj -> iud
azk -> pet
azl -> muy
azm -> gkx
azn -> vjt
azo -> vmx
azp -> zsa
azq -> sbk
azr -> dvp
azs -> wef
azt -> bmf
azu -> wjb
azv -> blc
azw -> rhx
azx -> jti
azy -> kvk
azz -> lyz
baa -> zfn
bab -> zwo
bac -> xch
bad -> mkf
bae -> anb
baf -> uhx
bag -> mvm
bah -> yzz
bai -> lms
baj -> ujr
bak -> dhq
bal -> jzj
bam -> xwp
ban -> iig
bao -> xnp
bap -> noe
baq -> nnk
bar -> kbv
bas -> oji
bat -> dkw
bau -> tks
bav -> nrj
baw -> dxj
bax -> ffj
bay -> wst
baz -> now
bba -> usy
bbb -> cfc
bbc -> fas
bbd -> oyo
bbe -> dci
bbf -> iqi
bbg -> elc
bbh -> xzk
bbi -> sua
bbj -> hee
bbk -> ktv
bbl -> swi
bbm -> htf
bbn -> cem
bbo -> jpv
bbp -> oux
bbq -> kxy
bbr -> oiz
bbs -> nzr
bbt -> zvh
bbu -> bvj
bbv -> qdx
bbw -> rdp
bbx -> jdt
bby -> rue
bbz -> ujm
bca -> efp
bcb -> nuy
bcc -> ril
bcd -> pwc
bce -> xic
bcf -> kuo
bcg -> djl
bch -> gue
bci -> nxp
bcj -> kkk
bck -> wgc
bcl -> nwb
bcm -> nux
bcn -> nhv
bco -> sog
bcp -> okn
bcq -> wni
bcr -> bhy
bcs -> mel
bct -> dcw
bcu -> tnj
bcv -> xkr
bcw -> smr
bcx -> jis
bcy -> ywb
bcz -> isw
bda -> ogd
bdb -> lee
bdc -> grd
bdd -> yut
bde -> lnj
bdf -> vui
bdg -> vaf
bdh -> jxg
bdi -> hwa
bdj -> qoq
bdk -> etq
bdl -> ifu
bdm -> vnp
bdn -> fdz
bdo -> iyc
bdp -> opu
bdq -> voi
bdr -> ezy
bds -> njy
bdt -> knu
bdu -> occ
bdv -> rri
bdw -> aci
bdx -> pwe
bdy -> cjp
bdz -> flf
bea -> adk
beb -> kjj
bec -> jtm
bed -> ein
bee -> zuh
bef -> ihu
beg -> pbe
beh -> eig
bei -> vow
bej -> dfl
bek -> fjy
bel -> glx
bem -> xrd
ben -> qlm
beo -> hbo
bep -> lff
beq -> jxk
ber -> ekw
bes -> fnm
bet -> tqe
beu -> axt
bev -> bqc
bew -> rys
bex -> sts
bey -> dsv
bez -> vst
bfa -> yvg
bfb -> vhm
bfc -> erz
bfd -> cse
bfe -> qgl
bff -> gxr
bfg -> wck
bfh -> dds
bfi -> pcx
bfj -> twb
bfk -> imr
bfl -> ddz
bfm -> cza
bfn -> xpm
bfo -> srd
bfp -> wsq
bfq -> pvl
bfr -> dmw
bfs -> udd
bft -> cdn
bfu -> poi
bfv -> sia
bfw -> sgs
bfx -> xaa
bfy -> eaf
bfz -> fdg
bga -> cnu
bgb -> msu
bgc -> sny
bgd -> swf
bge -> own
bgf -> dob
bgg -> npp
bgh -> cay
bgi -> tuq
bgj -> quq
bgk -> hid
bgl -> hta
bgm -> jmo
bgn -> nmt
bgo -> umj
bgp -> vdd
bgq -> ckw
bgr -> tfk
bgs -> ufh
bgt -> xor
bgu -> svk
bgv -> ttr
bgw -> ztm
bgx -> vso
bgy -> hix
bgz -> icb
bha -> ibr
bhb -> eoh
bhc -> dvi
bhd -> fnf
bhe -> mnb
bhf -> ruc
bhg -> von
bhh -> kdc
bhi -> kjm
bhj -> max
bhk -> nqw
bhl -> fxv
bhm -> tfl
bhn -> qha
bho -> laj
bhp -> jog
bhq -> khi
bhr -> zjc
bhs -> mvq
bht -> fwz
bhu -> qcv
bhv -> rqm
bhw -> wfs
bhx -> hse
bhy -> tlk
bhz -> fyh
bia -> hah
bib -> ops
bic -> pnx
bid -> tlz
bie -> dpd
bif -> llj
big -> vzs
bih -> zsj
bii -> lty
bij -> iew
bik -> zwd
bil -> ikx
bim -> gci
bin -> hut
bio -> rjo
bip -> nvl
biq -> eey
bir -> git
bis -> hjz
bit -> plh
biu -> tdw
biv -> yds
biw -> doh
bix -> axs
biy -> zmx
biz -> ejh
bja -> uoe
bjb -> zpv
bjc -> ckz
bjd -> hty
bje -> sgn
bjf -> ycz
bjg -> ldj
bjh -> cvb
bji -> phl
bjj -> geq
bjk -> khd
bjl -> wwq
bjm -> zxn
bjn -> ewi
bjo -> muk
bjp -> nqs
bjq -> hxp
bjr -> dhc
bjs -> bqe
bjt -> tft
bju -> ivs
bjv -> lny
bjw -> hqx
bjx -> plv
bjy -> pvt
bjz -> oly
bka -> sva
bkb -> eaw
bkc -> pan
bkd -> nrc
bke -> urg
bkf -> jeb
bkg -> gcv
bkh -> obp
bki -> kiz
bkj -> giu
bkk -> bzl
bkl -> pak
bkm -> rjq
bkn -> dto
bko -> hxm
bkp -> hvt
bkq -> vqj
bkr -> dly
bks -> qod
bkt -> ovs
bku -> mcm
bkv -> iez
bkw -> skz
bkx -> vjv
bky -> esh
bkz -> xvo
bla -> lli
blb -> bfa
blc -> ynb
bld -> dlx
ble -> xex
blf -> sfj
blg -> llh
blh -> qbq
bli -> bef
blj -> vud
blk -> lvc
bll -> cck
blm -> wls
bln -> rfd
blo -> yyg
blp -> bvx
blq -> qsh
blr -> fyw
bls -> xyj
blt -> adv
blu -> aui
blv -> ugm
blw -> wgf
blx -> tbd
bly -> khj
blz -> bpx
bma -> wqk
bmb -> qww
bmc -> uft
bmd -> nhk
bme -> zvm
bmf -> ghh
bmg -> gry
bmh -> rba
bmi -> ngb
bmj -> qwu
bmk -> vnb
bml -> ikr
bmm -> crz
bmn -> txy
bmo -> les
bmp -> znj
bmq -> ujx
bmr -> pfx
bms -> pby
bmt -> cmg
bmu -> lnl
bmv -> wsh
bmw -> nov
bmx -> qfm
bmy -> xtt
bmz -> mia
bna -> qtg
bnb -> xxn
bnc -> hed
bnd -> mbb
bne -> ojx
bnf -> elt
bng -> igm
bnh -> mxy
bni -> rxt
bnj -> pfa
bnk -> ulr
bnl -> hrw
bnm -> jja
bnn -> pjp
bno -> twj
bnp -> zob
bnq -> sle
bnr -> gzp
bns -> aew
bnt -> tuy
bnu -> dqb
bnv -> sfw
bnw -> byg
bnx -> mfy
bny -> gyv
bnz -> nrh
boa -> faz
bob -> ejk
boc -> mqw
bod -> zcl
boe -> mrn
bof -> hmg
bog -> gkg
boh -> tgv
boi -> kqj
boj -> hmk
bok -> pqw
bol -> hmh
bom -> ydy
bon -> hqq
boo -> hwb
bop -> kfl
boq -> srb
bor -> ady
bos -> dpp
bot -> uev
bou -> dof
bov -> npc
bow -> nub
box -> vyu
boy -> wvk
boz -> vzv
bpa -> ikm
bpb -> vna
bpc -> dfg
bpd -> vjp
bpe -> nue
bpf -> kng
bpg -> fzj
bph -> isq
bpi -> qog
bpj -> xwa
bpk -> fib
bpl -> jxu
bpm -> sft
bpn -> csw
bpo -> mtg
bpp -> akm
bpq -> wet
bpr -> fia
bps -> luw
bpt -> omr
bpu -> ids
bpv -> tbe
bpw -> pbq
bpx -> ooi
bpy -> mqm
bpz -> olq
bqa -> gwg
bqb -> gdu
bqc -> tob
bqd -> dsb
bqe -> eyh
bqf -> zqu
bqg -> wuy
bqh -> tdg
bqi -> owe
bqj -> kkj
bqk -> jth
bql -> uwp
bqm -> iqz
bqn -> ygy
bqo -> ibo
bqp -> szm
bqq -> tfw
bqr -> fkw
bqs -> owk
bqt -> fay
bqu -> jre
bqv -> owq
bqw -> uce
bqx -> emb
bqy -> ele
bqz -> bjz
bra -> pii
brb -> aqw
brc -> hjb
brd -> qpw
bre -> xfp
brf -> mry
brg -> mgf
brh -> mux
bri -> qry
brj -> aij
brk -> glu
brl -> rla
brm -> yen
brn -> quc
bro -> ygl
brp -> dix
brq -> fsy
brr -> cvx
brs -> ufo
brt -> zdf
bru -> ivr
brv -> zxw
brw -> adz
brx -> waa
bry -> bpv
brz -> lnr
bsa -> wos
bsb -> yzf
bsc -> pjq
bsd -> lag
bse -> beu
bsf -> pvp
bsg -> fok
bsh -> acv
bsi -> esv
bsj -> ugg
bsk -> iqh
bsl -> sbs
bsm -> jsy
bsn -> vgj
bso -> mqz
bsp -> bne
bsq -> ppj
bsr -> csa
bss -> nhm
bst -> pvv
bsu -> zhn
bsv -> cgg
bsw -> ian
bsx -> myv
bsy -> zda
bsz -> ize
bta -> wlv
btb -> gzo
btc -> the
btd -> sel
bte -> jqv
btf -> iun
btg -> edg
bth -> ixo
bti -> pye
btj -> kho
btk -> nfo
btl -> mcl
btm -> peq
btn -> eah
bto -> kjh
btp -> lks
btq -> qby
btr -> gwm
bts -> uhe
btt -> qfd
btu -> osk
btv -> yjc
btw -> bwx
btx -> mtb
bty -> lcp
btz -> yal
bua -> wsu
bub -> lcl
buc -> mid
bud -> wcn
bue -> erl
buf -> kup
bug -> iyd
buh -> zny
bui -> xub
buj -> ehg
buk -> dew
bul -> grm
bum -> nva
bun -> ykk
buo -> ykn
bup -> zlx
buq -> hwg
bur -> itt
bus -> cwu
but -> lzc
buu -> vhn
buv -> qkr
buw -> mmj
bux -> fhv
buy -> ufx
buz -> mix
bva -> orj
bvb -> xmw
bvc -> bjx
bvd -> nyf
bve -> tsy
bvf -> sop
bvg -> niw
bvh -> juv
bvi -> xuk
bvj -> jdm
bvk -> pko
bvl -> vqx
bvm -> iss
bvn -> wzj
bvo -> ykv
bvp -> uur
bvq -> ddx
bvr -> wuz
bvs -> qca
bvt -> lvu
bvu -> xit
bvv -> rvv
bvw -> pgy
bvx -> dap
bvy -> mrs
bvz -> raw
bwa -> fqs
bwb -> plc
bwc -> yui
bwd -> koi
bwe -> hrg
bwf -> oha
bwg -> aic
bwh -> rko
bwi -> oxx
bwj -> wwx
bwk -> mok
bwl -> kyx
bwm -> gky
bwn -> xlc
bwo -> ygx
bwp -> soe
bwq -> ykt
bwr -> hnh
bws -> zgc
bwt -> buz
bwu -> qwc
bwv -> bhg
bww -> ucs
bwx -> sna
bwy -> yav
bwz -> qpu
bxa -> gkz
bxb -> tjx
bxc -> mfu
bxd -> jan
bxe -> del
bxf -> xkg
bxg -> yjr
bxh -> mxe
bxi -> haz
bxj -> suq
bxk -> tne
bxl -> kcb
bxm -> zpc
bxn -> atl
bxo -> tnl
bxp -> mge
bxq -> nbb
bxr -> mbv
bxs -> kdj
bxt -> vvw
bxu -> kmf
bxv -> ppy
bxw -> khc
bxx -> uta
bxy -> baa
bxz -> jcy
bya -> ace
byb -> siq
byc -> xja
byd -> dnm
bye -> qqa
byf -> iuh
byg -> rkx
byh -> wda
byi -> tub
byj -> yeh
byk -> ach
byl -> aer
bym -> mfh
byn -> cir
byo -> mpt
byp -> hmq
byq -> dql
byr -> zce
bys -> dpr
byt -> xta
byu -> ihb
byv -> zow
byw -> jxy
byx -> kch
byy -> dwf
byz -> nou
bza -> lol
bzb -> owc
bzc -> vgv
bzd -> gys
bze -> nzf
bzf -> ajh
bzg -> dbp
bzh -> bez
bzi -> hic
bzj -> sck
bzk -> yux
bzl -> cmq
bzm -> hmv
bzn -> hyl
bzo -> jkh
bzp -> aju
bzq -> kif
bzr -> qbo
bzs -> vsy
bzt -> wff
bzu -> teb
bzv -> cqw
bzw -> phs
bzx -> lxr
bzy -> raq
bzz -> nbv
caa -> nza
cab -> eel
cac -> wfo
cad -> xfj
cae -> pqj
caf -> ogv
cag -> gib
cah -> vzz
cai -> bwn
caj -> pcc
cak -> dqf
cal -> jmd
cam -> zvv
can -> dqs
cao -> bqz
cap -> aor
caq -> yye
car -> vta
cas -> clb
cat -> uin
cau -> ohv
cav -> gdb
caw -> qpl
cax -> tng
cay -> rcc
caz -> nnz
cba -> dtl
cbb -> krh
cbc -> hww
cbd -> ihf
cbe -> rrb
cbf -> mpy
cbg -> rwf
cbh -> svt
cbi -> ndc
cbj -> ufp
cbk -> oxr
cbl -> qmu
cbm -> sea
cbn -> rrd
cbo -> hep
cbp -> onh
cbq -> jdi
cbr -> twa
cbs -> ety
cbt -> upm
cbu -> gvw
cbv -> ubx
cbw -> xvd
cbx -> sai
cby -> exp
cbz -> jpb
cca -> afr
ccb -> iyl
ccc -> fcm
ccd -> kbu
cce -> wam
ccf -> bpu
ccg -> abu
cch -> odv
cci -> kei
ccj -> wub
cck -> hmi
ccl -> tcn
ccm -> tce
ccn -> hkg
cco -> dvl
ccp -> hwf
ccq -> chr
ccr -> vrt
ccs -> ino
cct -> whf
ccu -> rpm
ccv -> rtk
ccw -> inc
ccx -> sja
ccy -> une
ccz -> bfj
cda -> xvi
cdb -> opw
cdc -> gqq
cdd -> jfs
cde -> vqg
cdf -> dyn
cdg -> oxc
cdh -> skv
cdi -> iwp
cdj -> yjh
cdk -> sfb
cdl -> tiv
cdm -> pfg
cdn -> ovh
cdo -> yeq
cdp -> dmk
cdq -> vyx
cdr -> idx
cds -> imo
cdt -> xlg
cdu -> ive
cdv -> gsu
cdw -> cib
cdx -> jlu
cdy -> njm
cdz -> kyj
cea -> ndt
ceb -> yva
cec -> cih
ced -> xui
cee -> joe
cef -> nkn
ceg -> dez
ceh -> mbs
cei -> lig
cej -> kek
cek -> cvv
cel -> bds
cem -> rdl
cen -> dhg
ceo -> xeq
cep -> axu
ceq -> tup
cer -> wtu
ces -> rfq
cet -> lbf
ceu -> jfi
cev -> ruk
cew -> vwa
cex -> bqb
cey -> vhq
cez -> bnd
cfa -> gfb
cfb -> lcf
cfc -> zdr
cfd -> rof
cfe -> dnb
cff -> pte
cfg -> axe
cfh -> rtg
cfi -> rmh
cfj -> ixa
cfk -> cxo
cfl -> ych
cfm -> mcj
cfn -> hra
cfo -> dmj
cfp -> egf
cfq -> nnn
cfr -> tpv
cfs -> itl
cft -> apl
cfu -> nyi
cfv -> vyc
cfw -> xvr
cfx -> olx
cfy -> lai
cfz -> iai
cga -> pjb
cgb -> rot
cgc -> wtr
cgd -> tmu
cge -> lpz
cgf -> yxl
cgg -> xff
cgh -> srl
cgi -> vze
cgj -> nat
cgk -> tjb
cgl -> hrj
cgm -> roe
cgn -> sra
cgo -> gaj
cgp -> uvr
cgq -> csz
cgr -> ksh
cgs -> ouv
cgt -> tyz
cgu -> ikf
cgv -> xoa
cgw -> gtc
cgx -> qos
cgy -> kmy
cgz -> jui
cha -> cdx
chb -> fbp
chc -> fdu
chd -> dus
che -> lsk
chf -> ckd
chg -> ttx
chh -> bxu
chi -> twl
chj -> hgw
chk -> sww
chl -> cho
chm -> lvn
chn -> rdx
cho -> iwb
chp -> gee
chq -> dfr
chr -> dpe
chs -> ocb
cht -> ywq
chu -> jdy
chv -> aud
chw -> sav
chx -> vfq
chy -> eyx
chz -> xet
cia -> kfh
cib -> evo
cic -> tou
cid -> urd
cie -> eeh
cif -> pdi
cig -> hfw
cih -> iaa
cii -> ykr
cij -> bth
cik -> auz
cil -> bog
cim -> ofx
cin -> sap
cio -> gaf
cip -> nfp
ciq -> gxd
cir -> btp
cis -> xur
cit -> brx
ciu -> elo
civ -> dkg
ciw -> ffw
cix -> lmn
ciy -> acd
ciz -> dtr
cja -> bni
cjb -> dsx
cjc -> gtl
cjd -> jjw
cje -> ici
cjf -> veh
cjg -> whz
cjh -> qfg
cji -> noh
cjj -> vke
cjk -> euw
cjl -> plw
cjm -> vww
cjn -> ljo
cjo -> ttu
cjp -> bdw
cjq -> nyp
cjr -> yli
cjs -> ylf
cjt -> otp
cju -> uas
cjv -> vxg
cjw -> fuo
cjx -> xlo
cjy -> cwd
cjz -> mfg
cka -> cuh
ckb -> xuw
ckc -> fsn
ckd -> rcq
cke -> pjr
ckf -> moz
ckg -> hlz
ckh -> pmn
cki -> gsm
ckj -> vmq
ckk -> ywi
ckl -> ubn
ckm -> ayc
ckn -> xro
cko -> dgn
ckp -> xaq
ckq -> fxm
ckr -> ndh
cks -> tpf
ckt -> tri
cku -> byq
ckv -> kel
ckw -> ntg
ckx -> kob
cky -> fnb
ckz -> ddr
cla -> rex
clb -> zof
clc -> pmp
cld -> xzg
cle -> pdh
clf -> ypj
clg -> mvr
clh -> bew
cli -> bmn
clj -> jzo
clk -> ifj
cll -> jyv
clm -> sjp
cln -> jfc
clo -> zfi
clp -> msj
clq -> mgy
clr -> vfg
cls -> xrl
clt -> lbo
clu -> mms
clv -> nce
clw -> bci
clx -> ced
cly -> evc
clz -> uqv
cma -> riv
cmb -> vql
cmc -> ybd
cmd -> fci
cme -> yfz
cmf -> wsg
cmg -> har
cmh -> jhm
cmi -> uoh
cmj -> dhs
cmk -> ygt
cml -> oqs
cmm -> qad
cmn -> dnj
cmo -> jur
cmp -> omc
cmq -> hqu
cmr -> cqo
cms -> ddv
cmt -> civ
cmu -> wfd
cmv -> zdm
cmw -> yve
cmx -> oss
cmy -> rnl
cmz -> wjc
cna -> ekn
cnb -> skb
cnc -> oku
cnd -> mmy
cne -> osj
cnf -> plo
cng -> tst
cnh -> ybf
cni -> ahx
cnj -> bcf
cnk -> xgk
cnl -> juh
cnm -> qpy
cnn -> ffm
cno -> bmx
cnp -> rmr
cnq -> das
cnr -> mwg
cns -> mcx
cnt -> kuz
cnu -> btn
cnv -> qoo
cnw -> peo
cnx -> whv
cny -> plp
cnz -> uks
coa -> yob
cob -> vei
coc -> czo
cod -> wmd
coe -> nvh
cof -> yqi
cog -> rgd
coh -> kal
coi -> kfv
coj -> jiy
cok -> rdj
col -> ofz
com -> ddi
con -> esx
coo -> dcl
cop -> ird
coq -> dem
cor -> mrx
cos -> wgo
cot -> jet
cou -> zbb
cov -> tda
cow -> ejs
cox -> xza
coy -> evn
coz -> ahg
cpa -> woq
cpb -> ldm
cpc -> oro
cpd -> uqn
cpe -> wzi
cpf -> wax
cpg -> bxw
cph -> cpd
cpi -> lea
cpj -> flw
cpk -> tkp
cpl -> xxm
cpm -> jjr
cpn -> yns
cpo -> iyy
cpp -> dzu
cpq -> yjs
cpr -> nve
cps -> lus
cpt -> ufr
cpu -> hnd
cpv -> nns
cpw -> qpa
cpx -> zzg
cpy -> tvz
cpz -> mty
cqa -> wgk
cqb -> stq
cqc -> jyc
cqd -> nis
cqe -> yzs
cqf -> iih
cqg -> qwa
cqh -> cdf
cqi -> wga
cqj -> efq
cqk -> xxj
cql -> zhe
cqm -> fvj
cqn -> qqd
cqo -> otc
cqp -> jqm
cqq -> rkc
cqr -> ymu
cqs -> qnt
cqt -> ohp
cqu -> phu
cqv -> oyn
cqw -> vou
cqx -> ifw
cqy -> qpz
cqz -> nkr
cra -> jyh
crb -> ftf
crc -> pwl
crd -> xax
cre -> pck
crf -> meq
crg -> ras
crh -> zux
cri -> fsc
crj -> aum
crk -> ude
crl -> bcd
crm -> kdn
crn -> bic
cro -> dec
crp -> rso
crq -> nzy
crr -> nau
crs -> rzg
crt -> rwi
cru -> zuu
crv -> xsa
crw -> ask
crx -> fvp
cry -> wki
crz -> dig
csa -> uvi
csb -> vjd
csc -> dma
csd -> gqa
cse -> qgq
csf -> bbl
csg -> uhs
csh -> iol
csi -> gxk
csj -> dtz
csk -> mcg
csl -> bwz
csm -> udm
csn -> lkk
cso -> nzk
csp -> daz
csq -> thr
csr -> wqj
css -> tur
cst -> zvt
csu -> jyt
csv -> sha
csw -> rhl
csx -> elj
csy -> eaq
csz -> qid
cta -> esw
ctb -> bmk
ctc -> isn
ctd -> sqx
cte -> mha
ctf -> vml
ctg -> rlo
cth -> zou
cti -> wqt
ctj -> uof
ctk -> tad
ctl -> one
ctm -> lnx
ctn -> xgv
cto -> grl
ctp -> avt
ctq -> uhy
ctr -> hri
cts -> rxo
ctt -> nor
ctu -> yjk
ctv -> esj
ctw -> oed
ctx -> vjf
cty -> vxs
ctz -> hod
cua -> uxe
cub -> obe
cuc -> lub
cud -> csl
cue -> uss
cuf -> tgm
cug -> wsm
cuh -> eom
cui -> ujy
cuj -> pws
cuk -> mzn
cul -> aid
cum -> ana
cun -> uzh
cuo -> uxa
cup -> hhc
cuq -> ocs
cur -> ddd
cus -> kys
cut -> aal
cuu -> oyq
cuv -> ikt
cuw -> hvb
cux -> chs
cuy -> wmh
cuz -> our
cva -> zlr
cvb -> iat
cvc -> yup
cvd -> hkv
cve -> hfv
cvf -> taw
cvg -> ohm
cvh -> wnp
cvi -> jez
cvj -> ozk
cvk -> gbf
cvl -> ewa
cvm -> aeo
cvn -> ahc
cvo -> dlz
cvp -> ekf
cvq -> wvs
cvr -> xxa
cvs -> yhu
cvt -> seu
cvu -> pio
cvv -> wly
cvw -> ujd
cvx -> eft
cvy -> ldo
cvz -> kwc
cwa -> ixg
cwb -> irv
cwc -> nlh
cwd -> hda
cwe -> kub
cwf -> okg
cwg -> htm
cwh -> vkv
cwi -> pdk
cwj -> dkn
cwk -> jss
cwl -> oxi
cwm -> qpf
cwn -> smx
cwo -> het
cwp -> qdm
cwq -> teo
cwr -> kps
cws -> ojw
cwt -> but
cwu -> sgl
cwv -> clo
cww -> mqj
cwx -> fwn
cwy -> csi
cwz -> txc
cxa -> fzx
cxb -> kxe
cxc -> oeo
cxd -> lpj
cxe -> drl
cxf -> xvv
cxg -> lui
cxh -> lkp
cxi -> ygs
cxj -> alh
cxk -> kgu
cxl -> fyj
cxm -> xdt
cxn -> btb
cxo -> wqw
cxp -> hzc
cxq -> pek
cxr -> sdq
cxs -> vtn
cxt -> xok
cxu -> xqp
cxv -> qbz
cxw -> zoi
cxx -> zma
cxy -> dre
cxz -> rcr
cya -> szg
cyb -> tyi
cyc -> wux
cyd -> bhj
cye -> kyi
cyf -> eho
cyg -> uai
cyh -> dqi
cyi -> rrg
cyj -> dzr
cyk -> chh
cyl -> rvi
cym -> pwi
cyn -> rlj
cyo -> ekx
cyp -> dzc
cyq -> ilm
cyr -> kxn
cys -> fjv
cyt -> fvq
cyu -> nlp
cyv -> brl
cyw -> cwq
cyx -> olf
cyy -> aen
cyz -> aap
cza -> niv
czb -> cjm
czc -> jky
czd -> xas
cze -> zvd
czf -> cxu
czg -> wvx
czh -> vao
czi -> kik
czj -> eip
czk -> okf
czl -> hlr
czm -> dod
czn -> dih
czo -> gug
czp -> hmt
czq -> glm
czr -> fbb
czs -> ezx
czt -> pfl
czu -> gxy
czv -> xez
czw -> oze
czx -> cxp
czy -> xey
czz -> ayt
daa -> wlc
dab -> izh
dac -> bfm
dad -> zet
dae -> fpt
daf -> ylw
dag -> bkp
dah -> hvq
dai -> cxy
daj -> nib
dak -> puy
dal -> kli
dam -> cas
dan -> sui
dao -> rzl
dap -> scf
daq -> zal
dar -> ega
das -> eqp
dat -> mni
dau -> hfe
dav -> vdk
daw -> zyp
dax -> nyu
day -> jmq
daz -> epv
dba -> eit
dbb -> tvy
dbc -> jhq
dbd -> sep
dbe -> cyv
dbf -> hns
dbg -> nws
dbh -> oob
dbi -> snh
dbj -> mdg
dbk -> wha
dbl -> hvw
dbm -> hfk
dbn -> usn
dbo -> cli
dbp -> mnw
dbq -> byv
dbr -> nhy
dbs -> htl
dbt -> qmq
dbu -> wnd
dbv -> plx
dbw -> ife
dbx -> ebw
dby -> goc
dbz -> uxc
dca -> qsd
dcb -> owr
dcc -> cfh
dcd -> kno
dce -> uih
dcf -> goo
dcg -> usw
dch -> oei
dci -> fmq
dcj -> qsb
dck -> yda
dcl -> thh
dcm -> ydf
dcn -> pjj
dco -> hvx
dcp -> umn
dcq -> dct
dcr -> uyk
dcs -> cpy
dct -> ayu
dcu -> ndo
dcv -> htn
dcw -> uvy
dcx -> hux
dcy -> jsh
dcz -> fvr
dda -> hws
ddb -> hmm
ddc -> hjm
ddd -> nwp
dde -> tqh
ddf -> eqx
ddg -> qcm
ddh -> dcu
ddi -> cmo
ddj -> ebj
ddk -> mmw
ddl -> bte
ddm -> sec
ddn -> hce
ddo -> qhp
ddp -> jmv
ddq -> erj
ddr -> mzr
dds -> zsv
ddt -> mfe
ddu -> lop
ddv -> hlm
ddw -> zhx
ddx -> wsj
ddy -> fen
ddz -> via
dea -> jpe
deb -> tgd
dec -> dxg
ded -> jkg
dee -> rrn
def -> bfq
deg -> oml
deh -> suv
dei -> nlk
dej -> wky
dek -> xmu
del -> lqm
dem -> ynq
den -> ahf
deo -> xiz
dep -> oie
deq -> fmp
der -> pys
des -> ywa
det -> opt
deu -> vbm
dev -> agu
dew -> mhn
dex -> ygf
dey -> ohc
dez -> lmw
dfa -> gae
dfb -> gzr
dfc -> ivx
dfd -> nuf
dfe -> ggo
dff -> uki
dfg -> yum
dfh -> vng
dfi -> kpm
dfj -> hav
dfk -> dcs
dfl -> way
dfm -> oco
dfn -> kgw
dfo -> vjh
dfp -> qtm
dfq -> xku
dfr -> pmb
dfs -> fgu
dft -> fmv
dfu -> exn
dfv -> cwg
dfw -> ilv
dfx -> gwx
dfy -> uwe
dfz -> trx
dga -> pof
dgb -> qir
dgc -> ttf
dgd -> ozb
dge -> lsa
dgf -> agj
dgg -> apc
dgh -> yfj
dgi -> iyh
dgj -> tph
dgk -> sno
dgl -> wov
dgm -> lmy
dgn -> weo
dgo -> gxl
dgp -> teg
dgq -> vhk
dgr -> zlp
dgs -> qer
dgt -> hhw
dgu -> vfh
dgv -> mdi
dgw -> wml
dgx -> wye
dgy -> nxu
dgz -> hoy
dha -> qfs
dhb -> wss
dhc -> gcs
dhd -> wgv
dhe -> pym
dhf -> uii
dhg -> muv
dhh -> wcg
dhi -> hts
dhj -> csj
dhk -> igf
dhl -> jex
dhm -> jkn
dhn -> ytv
dho -> sbq
dhp -> knj
dhq -> nck
dhr -> yft
dhs -> blq
dht -> wve
dhu -> jxw
dhv -> lii
dhw -> vob
dhx -> gyl
dhy -> tah
dhz -> xoq
dia -> xoh
dib -> jgf
dic -> wpe
did -> czd
die -> vyl
dif -> ocy
dig -> syp
dih -> kig
dii -> gwr
dij -> gbd
dik -> zqz
dil -> fxs
dim -> mns
din -> rif
dio -> qms
dip -> dyb
diq -> oxz
dir -> ajp
dis -> tlt
dit -> wfq
diu -> lwc
div -> cbc
diw -> qof
dix -> ift
diy -> wkg
diz -> iux
dja -> fio
djb -> enm
djc -> zjn
djd -> tey
dje -> saf
djf -> cqz
djg -> vrb
djh -> tut
dji -> xyx
djj -> mtj
djk -> vko
djl -> ecq
djm -> uuu
djn -> zxp
djo -> ncv
djp -> vqi
djq -> bcv
djr -> jev
djs -> yue
djt -> rxe
dju -> xtc
djv -> sqk
djw -> wtl
djx -> zwv
djy -> rkr
djz -> tsa
dka -> sso
dkb -> edc
dkc -> ocm
dkd -> ohl
dke -> ecu
dkf -> tnk
dkg -> shp
dkh -> qwe
dki -> fjf
dkj -> rgr
dkk -> jgz
dkl -> lni
dkm -> tdm
dkn -> ffb
dko -> fid
dkp -> kna
dkq -> ezq
dkr -> euh
dks -> ifb
dkt -> ben
dku -> yuv
dkv -> nug
dkw -> cdv
dkx -> vmv
dky -> dif
dkz -> scu
dla -> qyc
dlb -> exb
dlc -> uch
dld -> uel
dle -> vai
dlf -> hoz
dlg -> kie
dlh -> sbv
dli -> eqm
dlj -> vuk
dlk -> nof
dll -> nwo
dlm -> vce
dln -> zyj
dlo -> xzd
dlp -> anz
dlq -> swg
dlr -> imd
dls -> qvq
dlt -> ztt
dlu -> itg
dlv -> jcd
dlw -> ddw
dlx -> ixw
dly -> ttb
dlz -> pnc
dma -> agd
dmb -> epa
dmc -> nvy
dmd -> zyx
dme -> msy
dmf -> jla
dmg -> zdk
dmh -> eqe
dmi -> ayq
dmj -> lhk
dmk -> otg
dml -> hdj
dmm -> anw
dmn -> kdu
dmo -> ymb
dmp -> qxn
dmq -> smf
dmr -> gwy
dms -> hrh
dmt -> wdu
dmu -> lqd
dmv -> obt
dmw -> vuw
dmx -> hno
dmy -> him
dmz -> dwi
dna -> cqv
dnb -> qxv
dnc -> wcf
dnd -> wts
dne -> ohn
dnf -> iro
dng -> jad
dnh -> qcu
dni -> jrl
dnj -> meb
dnk -> enu
dnl -> puo
dnm -> kst
dnn -> jxb
dno -> tja
dnp -> yfc
dnq -> ild
dnr -> hpv
dns -> ehw
dnt -> ukd
dnu -> fww
dnv -> owj
dnw -> pnj
dnx -> hvs
dny -> kjb
dnz -> qkk
doa -> pty
dob -> nln
doc -> pfs
dod -> mph
doe -> rbl
dof -> cpv
dog -> gnp
doh -> myo
doi -> iev
doj -> esc
dok -> crp
dol -> lob
dom -> txo
don -> xxt
doo -> lca
dop -> fnp
doq -> gla
dor -> qok
dos -> qgz
dot -> ark
dou -> kwj
dov -> fcp
dow -> whc
dox -> fez
doy -> vgn
doz -> sho
dpa -> utx
dpb -> giz
dpc -> ofm
dpd -> myc
dpe -> pbj
dpf -> gzv
dpg -> jjm
dph -> vgh
dpi -> csk
dpj -> gpp
dpk -> kyy
dpl -> jfl
dpm -> jvb
dpn -> dkm
dpo -> jmf
dpp -> snp
dpq -> vni
dpr -> arb
dps -> dej
dpt -> ovd
dpu -> obi
dpv -> zcc
dpw -> isc
dpx -> frs
dpy -> xiq
dpz -> hmc
dqa -> kcf
dqb -> hro
dqc -> kzw
dqd -> gty
dqe -> aez
dqf -> ckk
dqg -> rrc
dqh -> fle
dqi -> ljs
dqj -> ryp
dqk -> qke
dql -> pzl
dqm -> azc
dqn -> pup
dqo -> bgc
dqp -> vlm
dqq -> cbs
dqr -> fvx
dqs -> ice
dqt -> wcb
dqu -> lok
dqv -> tlu
dqw -> wpx
dqx -> ozr
dqy -> kkb
dqz -> yka
dra -> jni
drb -> xtr
drc -> oph
drd -> woy
dre -> dkb
drf -> fld
drg -> fwd
drh -> xin
dri -> kqg
drj -> ttm
drk -> gqy
drl -> zva
drm -> ocu
drn -> amo
dro -> xec
drp -> eva
drq -> qvx
drr -> vtf
drs -> xqx
drt -> szh
dru -> qye
drv -> tjf
drw -> bld
drx -> ehq
dry -> nmk
drz -> qlp
dsa -> ozu
dsb -> ewr
dsc -> xie
dsd -> rht
dse -> guv
dsf -> akg
dsg -> pez
dsh -> qso
dsi -> ijq
dsj -> uot
dsk -> fiq
dsl -> oaf
dsm -> snr
dsn -> niq
dso -> geb
dsp -> oel
dsq -> qrq
dsr -> gde
dss -> klz
dst -> xvn
dsu -> kpg
dsv -> qre
dsw -> uka
dsx -> bjm
dsy -> pob
dsz -> vvd
dta -> uxf
dtb -> ylt
dtc -> mnj
dtd -> sdo
dte -> fsa
dtf -> vbb
dtg -> biv
dth -> lfj
dti -> kzj
dtj -> bml
dtk -> zfj
dtl -> hyv
dtm -> you
dtn -> gqr
dto -> mkg
dtp -> kkt
dtq -> zaj
dtr -> ofg
dts -> duw
dtt -> ilq
dtu -> scz
dtv -> fbx
dtw -> nnl
dtx -> pua
dty -> hbh
dtz -> kyr
dua -> buh
dub -> jpp
duc -> zbd
dud -> sir
due -> mmr
duf -> gnw
dug -> cro
duh -> ghg
dui -> nle
duj -> suo
duk -> obm
dul -> auw
dum -> bjc
dun -> erx
duo -> hgu
dup -> dnc
duq -> cvd
dur -> iwk
dus -> swc
dut -> upy
duu -> nlf
duv -> rnn
duw -> uph
dux -> jqb
duy -> qnx
duz -> aak
dva -> xlj
dvb -> gyh
dvc -> alr
dvd -> cpp
dve -> cpb
dvf -> zzs
dvg -> hsx
dvh -> oju
dvi -> wfl
dvj -> mqc
dvk -> pag
dvl -> obc
dvm -> gjn
dvn -> ugi
dvo -> nij
dvp -> vsu
dvq -> cng
dvr -> rmg
dvs -> ugo
dvt -> qit
dvu -> xym
dvv -> vtw
dvw -> zih
dvx -> gju
dvy -> hax
dvz -> tqi
dwa -> emg
dwb -> lpw
dwc -> tav
dwd -> osm
dwe -> csq
dwf -> kwb
dwg -> yad
dwh -> pzo
dwi -> vnj
dwj -> val
dwk -> vyy
dwl -> sce
dwm -> jno
dwn -> rnb
dwo -> fri
dwp -> jfn
dwq -> dzl
dwr -> pei
dws -> frp
dwt -> lld
dwu -> pgf
dwv -> ytx
dww -> zln
dwx -> kfo
dwy -> ctb
dwz -> hjp
dxa -> grc
dxb -> skw
dxc -> ses
dxd -> isp
dxe -> grz
dxf -> bep
dxg -> coe
dxh -> vsw
dxi -> vdf
dxj -> foq
dxk -> ofh
dxl -> ljh
dxm -> qcc
dxn -> omi
dxo -> xlt
dxp -> zrs
dxq -> shf
dxr -> zxr
dxs -> dos
dxt -> nvf
dxu -> cfo
dxv -> xvm
dxw -> fac
dxx -> que
dxy -> emd
dxz -> mgz
dya -> zbp
dyb -> pqc
dyc -> ndg
dyd -> qxy
dye -> djy
dyf -> efz
dyg -> cjq
dyh -> qmb
dyi -> efs
dyj -> jab
dyk -> mgu
dyl -> ejn
dym -> ixn
dyn -> bdp
dyo -> ndn
dyp -> xgl
dyq -> ptj
dyr -> rkm
dys -> pcr
dyt -> krs
dyu -> lhw
dyv -> jms
dyw -> kpx
dyx -> fqf
dyy -> sdr
dyz -> hsn
dza -> dva
dzb -> pgq
dzc -> cor
dzd -> vvu
dze -> auy
dzf -> mlq
dzg -> eyt
dzh -> vdz
dzi -> byi
dzj -> zol
dzk -> mze
dzl -> tfh
dzm -> sro
dzn -> rjx
dzo -> ixr
dzp -> era
dzq -> rzs
dzr -> rvm
dzs -> cnv
dzt -> usz
dzu -> eyb
dzv -> mln
dzw -> fpo
dzx -> bks
dzy -> xcc
dzz -> mwr
eaa -> jpf
eab -> lws
eac -> sly
ead -> vnn
eae -> coy
eaf -> vlo
eag -> avf
eah -> ung
eai -> fze
eaj -> mox
eak -> aae
eal -> bwe
eam -> kec
ean -> mbg
eao -> gsx
eap -> wgm
eaq -> zjz
ear -> sjj
eas -> qgu
eat -> opi
eau -> kau
eav -> keb
eaw -> ong
eax -> dla
eay -> axw
eaz -> gmu
eba -> bmi
ebb -> axn
ebc -> qxr
ebd -> nkm
ebe -> leq
ebf -> zzn
ebg -> bqk
ebh -> uxx
ebi -> aqk
ebj -> rvo
ebk -> axz
ebl -> rtu
ebm -> zkd
ebn -> edi
ebo -> qmc
ebp -> ppx
ebq -> qgj
ebr -> udc
ebs -> erw
ebt -> boj
ebu -> cdm
ebv -> umo
ebw -> sxd
ebx -> pje
eby -> avq
ebz -> awo
eca -> yaz
ecb -> ydh
ecc -> unl
ecd -> lmi
ece -> ybi
ecf -> azo
ecg -> iqs
ech -> vsg
eci -> yts
ecj -> zuq
eck -> fch
ecl -> jjb
ecm -> fyr
ecn -> jtc
eco -> hke
ecp -> syb
ecq -> cji
ecr -> gpc
ecs -> hna
ect -> pvr
ecu -> tpo
ecv -> mld
ecw -> ypn
ecx -> ikv
ecy -> rug
ecz -> vzl
eda -> cnl
edb -> hpn
edc -> uqb
edd -> baq
ede -> pla
edf -> svi
edg -> okr
edh -> wqf
edi -> dqa
edj -> ije
edk -> ahd
edl -> yxq
edm -> fdh
edn -> yjy
edo -> uzz
edp -> ehl
edq -> aog
edr -> hqj
eds -> tkj
edt -> pwz
edu -> vqc
edv -> mme
edw -> jvq
edx -> ros
edy -> hpg
edz -> rdn
eea -> uwm
eeb -> hpd
eec -> aao
eed -> bno
eee -> owa
eef -> fhd
eeg -> urt
eeh -> bgt
eei -> iks
eej -> shc
eek -> rck
eel -> pnw
eem -> kyo
een -> iip
eeo -> eql
eep -> vih
eeq -> tve
eer -> jyg
ees -> lge
eet -> bju
eeu -> cju
eev -> pwu
eew -> cns
eex -> qqe
eey -> gck
eez -> ebt
efa -> bfx
efb -> bhc
efc -> vmo
efd -> axo
efe -> ulw
eff -> ghu
efg -> cve
efh -> ubk
efi -> wbd
efj -> kim
efk -> zyw
efl -> wzl
efm -> lfn
efn -> pkf
efo -> bid
efp -> zcn
efq -> wyb
efr -> udn
efs -> yzb
eft -> ahs
efu -> day
efv -> esg
efw -> rqg
efx -> izr
efy -> ixd
efz -> lwv
ega -> pyd
egb -> ujk
egc -> yjv
egd -> cjl
ege -> ebr
egf -> emx
egg -> irw
egh -> yah
egi -> tvf
egj -> eim
egk -> nvw
egl -> pat
egm -> shg
egn -> sze
ego -> yyh
egp -> rwu
egq -> hgk
egr -> xlf
egs -> acp
egt -> uro
egu -> ewf
egv -> bhl
egw -> fcs
egx -> izc
egy -> bsg
egz -> axi
eha -> xpk
ehb -> puf
ehc -> wgt
ehd -> fhk
ehe -> nxr
ehf -> ena
ehg -> dxe
ehh -> pwt
ehi -> fyl
ehj -> yis
ehk -> ajy
ehl -> aco
ehm -> nav
ehn -> kix
eho -> caz
ehp -> uqj
ehq -> xtn
ehr -> aqq
ehs -> clh
eht -> eiw
ehu -> pqi
ehv -> ksm
ehw -> hyo
ehx -> wlz
ehy -> gwv
ehz -> oqj
eia -> mee
eib -> ofi
eic -> ahn
eid -> hms
eie -> zoq
eif -> ddc
eig -> uvd
eih -> izn
eii -> bhz
eij -> zbw
eik -> hqa
eil -> zuo
eim -> nox
ein -> jct
eio -> jwq
eip -> ain
eiq -> nnr
eir -> uyv
eis -> lpe
eit -> dtc
eiu -> bod
eiv -> pgj
eiw -> rod
eix -> cfk
eiy -> avz
eiz -> kkd
eja -> xqe
ejb -> uze
ejc -> hjf
ejd -> xac
eje -> mvh
ejf -> ezj
ejg -> ese
ejh -> duz
eji -> ikb
ejj -> mop
ejk -> gtq
ejl -> hrl
ejm -> ipl
ejn -> wdg
ejo -> tmz
ejp -> alt
ejq -> yuc
ejr -> vat
ejs -> oip
ejt -> vym
eju -> aby
ejv -> mqe
ejw -> fcr
ejx -> tck
ejy -> kbh
ejz -> mbr
eka -> viy
ekb -> uwi
ekc -> hia
ekd -> mjj
eke -> ral
ekf -> ccq
ekg -> tyr
ekh -> tdu
eki -> nil
ekj -> ypk
ekk -> oyt
ekl -> vws
ekm -> irt
ekn -> fgo
eko -> ufc
ekp -> bln
ekq -> fgq
ekr -> qhm
eks -> rgq
ekt -> jvz
eku -> bzo
ekv -> nxd
ekw -> xuu
ekx -> clu
eky -> bfr
ekz -> yzj
ela -> czt
elb -> zcv
elc -> ska
eld -> kzh
ele -> loj
elf -> dnk
elg -> qnb
elh -> byh
eli -> ium
elj -> ldk
elk -> qaa
ell -> hqk
elm -> ley
eln -> wrx
elo -> uxn
elp -> brf
elq -> kto
elr -> xyy
els -> byk
elt -> lmu
elu -> qfx
elv -> mab
elw -> ydr
elx -> cde
ely -> uaz
elz -> rmx
ema -> tyx
emb -> rav
emc -> xih
emd -> rxd
eme -> uaa
emf -> cmd
emg -> lix
emh -> tvq
emi -> geh
emj -> ozt
emk -> mnc
eml -> udi
emm -> xzz
emn -> kqn
emo -> pgt
emp -> jka
emq -> tcf
emr -> trc
ems -> eqg
emt -> irb
emu -> ood
emv -> cxr
emw -> xpu
emx -> rdo
emy -> yfg
emz -> sie
ena -> pnp
enb -> ukl
enc -> hdw
end -> xhc
ene -> txk
enf -> bdr
eng -> vsn
enh -> trh
eni -> ico
enj -> azy
enk -> jjo
enl -> ypf
enm -> son
enn -> mgb
eno -> jps
enp -> fed
enq -> bau
enr -> pjd
ens -> huh
ent -> aaa
enu -> yre
env -> wsw
enw -> kjp
enx -> rvb
eny -> mnd
enz -> rsy
eoa -> rvs
eob -> wdi
eoc -> poq
eod -> pil
eoe -> fni
eof -> waw
eog -> dmt
eoh -> krd
eoi -> aji
eoj -> qea
eok -> zox
eol -> cfg
eom -> mca
eon -> atm
eoo -> dys
eop -> swr
eoq -> pbu
eor -> efv
eos -> nqz
eot -> ozp
eou -> wvw
eov -> scg
eow -> iri
eox -> aig
eoy -> vxj
eoz -> cjj
epa -> frz
epb -> agl
epc -> epk
epd -> fzz
epe -> mal
epf -> qik
epg -> uaw
eph -> bqt
epi -> gvq
epj -> jya
epk -> kvd
epl -> wal
epm -> lrz
epn -> hbp
epo -> fxe
epp -> ydu
epq -> rds
epr -> kez
eps -> nig
ept -> dji
epu -> qpc
epv -> pit
epw -> xoc
epx -> vdn
epy -> bmh
epz -> zmq
eqa -> wjs
eqb -> yxf
eqc -> ywr
eqd -> wiw
eqe -> nbi
eqf -> dpg
eqg -> zlb
eqh -> zoa
eqi -> ajq
eqj -> xsr
eqk -> gpv
eql -> cmi
eqm -> ysr
eqn -> dco
eqo -> dhf
eqp -> exe
eqq -> jtb
eqr -> ycr
eqs -> nsq
eqt -> xse
equ -> dby
eqv -> jdl
eqw -> kqd
eqx -> lex
eqy -> ovi
eqz -> qla
era -> pgp
erb -> srt
erc -> obw
erd -> jgc
ere -> oag
erf -> kga
erg -> dms
erh -> ytg
eri -> pgo
erj -> hsw
erk -> ovr
erl -> wdb
erm -> iad
ern -> chv
ero -> jfb
erp -> yul
erq -> fjj
err -> xdy
ers -> pcy
ert -> vim
eru -> yhm
erv -> itc
erw -> vid
erx -> dgx
ery -> tbf
erz -> zdh
esa -> gvb
esb -> ode
esc -> arh
esd -> eux
ese -> llu
esf -> mpb
esg -> bzd
esh -> yhw
esi -> yqn
esj -> gbt
esk -> sql
esl -> lvz
esm -> ioz
esn -> ezo
eso -> waj
esp -> pal
esq -> avo
esr -> npb
ess -> ohi
est -> xwq
esu -> jhg
esv -> rsi
esw -> owm
esx -> kfy
esy -> lxh
esz -> ggn
eta -> ydg
etb -> lir
etc -> dxw
etd -> mbd
ete -> won
etf -> amb
etg -> ycu
eth -> rqu
eti -> ncf
etj -> wzx
etk -> css
etl -> spc
etm -> rdb
etn -> mat
eto -> hgd
etp -> swz
etq -> wxu
etr -> eqn
ets -> zbm
ett -> clq
etu -> jce
etv -> ssx
etw -> mpj
etx -> zwy
ety -> wyc
etz -> uyo
eua -> smi
eub -> lza
euc -> kfr
eud -> fxz
eue -> pqg
euf -> jlf
eug -> zto
euh -> zzm
eui -> yrm
euj -> ntu
euk -> ccm
eul -> ilo
eum -> lgy
eun -> pdc
euo -> dlp
eup -> uds
euq -> mxd
eur -> xsn
eus -> laz
eut -> xws
euu -> uiy
euv -> dhw
euw -> lhn
eux -> mub
euy -> fuf
euz -> xir
eva -> bvv
evb -> bvz
evc -> vjj
evd -> xcw
eve -> yhn
evf -> gqx
evg -> axg
evh -> kab
evi -> lfe
evj -> hzp
evk -> dyz
evl -> tat
evm -> zer
evn -> ltu
evo -> dhp
evp -> dtu
evq -> ziq
evr -> dhd
evs -> klb
evt -> akl
evu -> ztl
evv -> zte
evw -> fow
evx -> jdo
evy -> mis
evz -> hpu
ewa -> nxw
ewb -> tpm
ewc -> pxd
ewd -> twm
ewe -> hxq
ewf -> omz
ewg -> srs
ewh -> ybt
ewi -> ouj
ewj -> yjn
ewk -> vvf
ewl -> xlw
ewm -> pdm
ewn -> gdo
ewo -> zvw
ewp -> seh
ewq -> thi
ewr -> dun
ews -> pst
ewt -> pex
ewu -> glr
ewv -> oih
eww -> cnt
ewx -> tpz
ewy -> gbr
ewz -> mwl
exa -> vwu
exb -> tll
exc -> cig
exd -> ofe
exe -> sio
exf -> oge
exg -> lfq
exh -> oko
exi -> nop
exj -> ojg
exk -> jvg
exl -> jsm
exm -> jzq
exn -> frf
exo -> sol
exp -> huo
exq -> jhp
exr -> ltt
exs -> okj
ext -> tuk
exu -> atq
exv -> fbj
exw -> mhv
exx -> ksa
exy -> gxv
exz -> jfr
eya -> ihp
eyb -> arv
eyc -> suy
eyd -> pea
eye -> whg
eyf -> pju
eyg -> wez
eyh -> sni
eyi -> zat
eyj -> gor
eyk -> jfo
eyl -> wvy
eym -> wfi
eyn -> msf
eyo -> jol
eyp -> sew
eyq -> pdx
eyr -> gso
eys -> nik
eyt -> zjd
eyu -> ruu
eyv -> pzt
eyw -> jea
eyx -> noa
eyy -> xel
eyz -> sth
eza -> jen
ezb -> tao
ezc -> rjb
ezd -> fka
eze -> tbc
ezf -> pwx
ezg -> ybl
ezh -> osq
ezi -> nnt
ezj -> wii
ezk -> hwz
ezl -> mtx
ezm -> bjq
ezn -> ysi
ezo -> see
ezp -> uwb
ezq -> evu
ezr -> ukj
ezs -> xjx
ezt -> rzu
ezu -> ntt
ezv -> hvm
ezw -> wxj
ezx -> ttv
ezy -> wkk
ezz -> zev
faa -> clx
fab -> rga
fac -> ndw
fad -> fda
fae -> gjw
faf -> pga
fag -> mxq
fah -> zwu
fai -> dzx
faj -> hbx
fak -> ffq
fal -> vva
fam -> qwo
fan -> yxe
fao -> lnf
fap -> pgr
faq -> bdg
far -> rqt
fas -> cwm
fat -> knc
fau -> jzk
fav -> hdr
faw -> xuz
fax -> lnm
fay -> nua
faz -> xva
fba -> dis
fbb -> uon
fbc -> uda
fbd -> ibj
fbe -> umw
fbf -> dea
fbg -> acr
fbh -> aec
fbi -> kgf
fbj -> lad
fbk -> nuz
fbl -> ftw
fbm -> xmj
fbn -> hqy
fbo -> owt
fbp -> cvq
fbq -> rme
fbr -> xag
fbs -> eqs
fbt -> eyc
fbu -> ual
fbv -> chn
fbw -> ocf
fbx -> ywe
fby -> pom
fbz -> nte
fca -> rya
fcb -> avv
fcc -> wcu
fcd -> eal
fce -> piu
fcf -> uhz
fcg -> otu
fch -> vrn
fci -> end
fcj -> hvo
fck -> sfa
fcl -> osw
fcm -> ghk
fcn -> poy
fco -> uli
fcp -> xos
fcq -> vhe
fcr -> vsm
fcs -> sqv
fct -> iep
fcu -> twf
fcv -> vvm
fcw -> utv
fcx -> ijw
fcy -> qoi
fcz -> ifn
fda -> clc
fdb -> dgc
fdc -> hyw
fdd -> yvd
fde -> bwf
fdf -> tan
fdg -> mch
fdh -> exc
fdi -> rmt
fdj -> kfu
fdk -> exr
fdl -> hec
fdm -> ynh
fdn -> ktt
fdo -> knq
fdp -> lrt
fdq -> mma
fdr -> qra
fds -> ipw
fdt -> mja
fdu -> yyb
fdv -> yyi
fdw -> oqx
fdx -> ccw
fdy -> xcd
fdz -> ski
fea -> yno
feb -> tmm
fec -> mnh
fed -> lrj
fee -> gix
fef -> gtn
feg -> hdt
feh -> ruf
fei -> fkp
fej -> nog
fek -> euv
fel -> taz
fem -> qyl
fen -> htr
feo -> ide
fep -> yor
feq -> xbb
fer -> mjv
fes -> kaj
fet -> yko
feu -> yso
fev -> fdo
few -> uec
fex -> fwy
fey -> nvj
fez -> pxp
ffa -> cwj
ffb -> lmh
ffc -> gko
ffd -> tcw
ffe -> jgg
fff -> upr
ffg -> wpm
ffh -> ydk
ffi -> kdw
ffj -> kff
ffk -> jiz
ffl -> bqi
ffm -> lgr
ffn -> rvx
ffo -> eka
ffp -> opy
ffq -> sah
ffr -> awy
ffs -> qnp
fft -> qav
ffu -> huu
ffv -> upt
ffw -> env
ffx -> ekl
ffy -> crq
ffz -> jks
fga -> pih
fgb -> dxa
fgc -> mwb
fgd -> dfz
fge -> rwt
fgf -> tzw
fgg -> nsh
fgh -> uoy
fgi -> slw
fgj -> bma
fgk -> tmk
fgl -> xju
fgm -> ghn
fgn -> wfg
fgo -> ebq
fgp -> nqi
fgq -> hlj
fgr -> and
fgs -> ckx
fgt -> kby
fgu -> qfz
fgv -> yxn
fgw -> zig
fgx -> dzi
fgy -> zoo
fgz -> niy
fha -> noi
fhb -> kud
fhc -> wxa
fhd -> rmf
fhe -> jul
fhf -> aqu
fhg -> rvz
fhh -> hjt
fhi -> wig
fhj -> guf
fhk -> oxu
fhl -> dxo
fhm -> cyy
fhn -> cfe
fho -> oaa
fhp -> ysp
fhq -> huc
fhr -> ods
fhs -> ans
fht -> qhl
fhu -> vld
fhv -> tpt
fhw -> vho
fhx -> aax
fhy -> sdw
fhz -> snq
fia -> rgf
fib -> yjx
fic -> fsv
fid -> wuf
fie -> sxl
fif -> vpy
fig -> jek
fih -> ncg
fii -> cjy
fij -> fae
fik -> onw
fil -> mdc
fim -> itp
fin -> yqt
fio -> gjg
fip -> sgh
fiq -> poj
fir -> lay
fis -> wtg
fit -> svh
fiu -> phv
fiv -> kre
fiw -> atr
fix -> pus
fiy -> rzw
fiz -> cfi
fja -> qah
fjb -> ovq
fjc -> grs
fjd -> tam
fje -> icn
fjf -> cjn
fjg -> fhm
fjh -> mfc
fji -> nsd
fjj -> yqd
fjk -> qds
fjl -> zog
fjm -> nwe
fjn -> bkq
fjo -> egm
fjp -> wnf
fjq -> dge
fjr -> vqs
fjs -> jvw
fjt -> xjc
fju -> iyi
fjv -> woh
fjw -> xad
fjx -> ldi
fjy -> mrh
fjz -> hrz
fka -> yrd
fkb -> tio
fkc -> cxv
fkd -> cyi
fke -> uji
fkf -> fdj
fkg -> jxi
fkh -> fvy
fki -> uqa
fkj -> hdi
fkk -> gfe
fkl -> wuq
fkm -> soz
fkn -> wpq
fko -> moa
fkp -> bxa
fkq -> joj
fkr -> fbz
fks -> fua
fkt -> mhi
fku -> ypq
fkv -> vdp
fkw -> hui
fkx -> yhe
fky -> pde
fkz -> tbi
fla -> eam
flb -> zez
flc -> aqg
fld -> ytm
fle -> zkl
flf -> lfg
flg -> jag
flh -> jlx
fli -> lfh
flj -> iuk
flk -> ezm
fll -> pai
flm -> bdm
fln -> ilr
flo -> bpi
flp -> bbj
flq -> tpi
flr -> pwv
fls -> bwg
flt -> jpo
flu -> gfj
flv -> azl
flw -> jai
flx -> div
fly -> uen
flz -> dcy
fma -> qlj
fmb -> rcf
fmc -> qot
fmd -> swj
fme -> tmj
fmf -> ydt
fmg -> alv
fmh -> lhv
fmi -> trm
fmj -> idm
fmk -> ysm
fml -> jyb
fmm -> qdc
fmn -> veb
fmo -> grq
fmp -> wes
fmq -> oas
fmr -> nwm
fms -> wsk
fmt -> xtf
fmu -> rte
fmv -> rch
fmw -> iqn
fmx -> wpv
fmy -> hhj
fmz -> srv
fna -> etx
fnb -> gob
fnc -> ndi
fnd -> sar
fne -> trg
fnf -> ndv
fng -> ged
fnh -> gpg
fni -> byl
fnj -> kiy
fnk -> vdm
fnl -> wmj
fnm -> azk
fnn -> gtf
fno -> cyh
fnp -> whl
fnq -> rbh
fnr -> txq
fns -> gpy
fnt -> qxg
fnu -> kdh
fnv -> czn
fnw -> lsq
fnx -> nbc
fny -> tnp
fnz -> ghq
foa -> qvi
fob -> hbn
foc -> nvi
fod -> zdt
foe -> wxm
fof -> cus
fog -> she
foh -> gzd
foi -> ejb
foj -> wih
fok -> bhf
fol -> twn
fom -> kwk
fon -> pkp
foo -> ruv
fop -> iav
foq -> bfe
for -> qae
fos -> ial
fot -> rbk
fou -> puc
fov -> aup
fow -> uwx
fox -> wyt
foy -> uni
foz -> tzh
fpa -> yol
fpb -> qks
fpc -> isz
fpd -> thl
fpe -> emu
fpf -> dil
fpg -> snt
fph -> feb
fpi -> ipy
fpj -> bst
fpk -> wpn
fpl -> lhe
fpm -> lpd
fpn -> iab
fpo -> xrs
fpp -> dxb
fpq -> hho
fpr -> dzt
fps -> juj
fpt -> ohs
fpu -> bnk
fpv -> lvw
fpw -> qnq
fpx -> gsf
fpy -> oow
fpz -> vbg
fqa -> vxf
fqb -> kdm
fqc -> anu
fqd -> yrb
fqe -> hdo
fqf -> ctt
fqg -> por
fqh -> imt
fqi -> ank
fqj -> inl
fqk -> suz
fql -> shd
fqm -> wjo
fqn -> whr
fqo -> xbz
fqp -> vxb
fqq -> iyv
fqr -> vtg
fqs -> dda
fqt -> ect
fqu -> vkp
fqv -> wgn
fqw -> wqo
fqx -> kac
fqy -> dmb
fqz -> mzt
fra -> gsg
frb -> xmn
frc -> olg
frd -> hkt
fre -> flg
frf -> fwo
frg -> gfc
frh -> qgh
fri -> msd
frj -> sdj
frk -> yim
frl -> dtb
frm -> gyp
frn -> knp
fro -> ica
frp -> uca
frq -> feg
frr -> fmj
frs -> ukq
frt -> gnu
fru -> wxk
frv -> jhc
frw -> ugj
frx -> sfc
fry -> fyb
frz -> dnh
fsa -> oxj
fsb -> ayn
fsc -> zbh
fsd -> ucz
fse -> cti
fsf -> mwe
fsg -> vji
fsh -> tsl
fsi -> leb
fsj -> mgd
fsk -> vno
fsl -> dph
fsm -> asg
fsn -> oil
fso -> zla
fsp -> kdd
fsq -> qqy
fsr -> cqc
fss -> uhj
fst -> tye
fsu -> aat
fsv -> jbo
fsw -> jwn
fsx -> rvf
fsy -> eea
fsz -> ygw
fta -> jtv
ftb -> xmg
ftc -> ahk
ftd -> exa
fte -> nay
ftf -> bev
ftg -> rix
fth -> roj
fti -> hkf
ftj -> qqi
ftk -> bzt
ftl -> udx
ftm -> uzy
ftn -> zvo
fto -> ikz
ftp -> vra
ftq -> nzo
ftr -> kvv
fts -> hyp
ftt -> gsa
ftu -> mnm
ftv -> aql
ftw -> jtj
ftx -> lfz
fty -> hyy
ftz -> fvh
fua -> hgs
fub -> iuf
fuc -> jzm
fud -> dbi
fue -> elz
fuf -> ndf
fug -> pbx
fuh -> hhf
fui -> vtr
fuj -> idw
fuk -> uoj
ful -> ebv
fum -> cew
fun -> maj
fuo -> znk
fup -> kzv
fuq -> lzv
fur -> ibe
fus -> tuc
fut -> mzz
fuu -> cpo
fuv -> sot
fuw -> nzb
fux -> sdd
fuy -> sty
fuz -> rxm
fva -> vfz
fvb -> ord
fvc -> nyy
fvd -> qao
fve -> gfw
fvf -> luj
fvg -> ukt
fvh -> geg
fvi -> dlj
fvj -> bym
fvk -> dsr
fvl -> jzf
fvm -> zqj
fvn -> vdj
fvo -> rwj
fvp -> xsd
fvq -> tnm
fvr -> mcy
fvs -> pbm
fvt -> rdr
fvu -> tue
fvv -> qct
fvw -> lbe
fvx -> rpu
fvy -> elk
fvz -> mlb
fwa -> nmu
fwb -> qim
fwc -> ieg
fwd -> njf
fwe -> vfv
fwf -> fbv
fwg -> nxl
fwh -> jws
fwi -> ave
fwj -> toj
fwk -> ulk
fwl -> yfb
fwm -> rmj
fwn -> uqe
fwo -> hlc
fwp -> mgp
fwq -> hxb
fwr -> upz
fws -> btw
fwt -> dow
fwu -> jgv
fwv -> wty
fww -> dde
fwx -> lrl
fwy -> egq
fwz -> ogc
fxa -> kvw
fxb -> rwa
fxc -> goy
fxd -> zbs
fxe -> oxb
fxf -> hnp
fxg -> zcs
fxh -> ntz
fxi -> evv
fxj -> uqd
fxk -> rjv
fxl -> jwr
fxm -> xcp
fxn -> pbl
fxo -> squ
fxp -> wjq
fxq -> rsx
fxr -> gum
fxs -> ttz
fxt -> tab
fxu -> vmt
fxv -> hzg
fxw -> dqn
fxx -> rbo
fxy -> kaq
fxz -> tiw
fya -> gez
fyb -> ylr
fyc -> bxg
fyd -> haw
fye -> uxd
fyf -> psn
fyg -> uct
fyh -> lxe
fyi -> gaa
fyj -> xho
fyk -> nvn
fyl -> fjn
fym -> fth
fyn -> gbw
fyo -> frq
fyp -> dbg
fyq -> jcm
fyr -> sff
fys -> kds
fyt -> gsk
fyu -> zek
fyv -> jnc
fyw -> bie
fyx -> svg
fyy -> ieo
fyz -> fqx
fza -> moh
fzb -> lco
fzc -> psh
fzd -> rgh
fze -> dkq
fzf -> xgw
fzg -> ymo
fzh -> kcl
fzi -> bky
fzj -> llo
fzk -> gdq
fzl -> vfa
fzm -> upl
fzn -> bey
fzo -> mwo
fzp -> ksd
fzq -> cga
fzr -> ucd
fzs -> vfn
fzt -> uvu
fzu -> xqd
fzv -> jjx
fzw -> hja
fzx -> xmp
fzy -> ljj
fzz -> kso
gaa -> mtd
gab -> iuw
gac -> gwn
gad -> odk
gae -> mrm
gaf -> ogt
gag -> khy
gah -> vdo
gai -> swn
gaj -> hjc
gak -> hkj
gal -> mro
gam -> dcz
gan -> hcj
gao -> ghs
gap -> jdv
gaq -> gad
gar -> scp
gas -> wsz
gat -> oir
gau -> yqg
gav -> nsf
gaw -> vii
gax -> alu
gay -> dqq
gaz -> ner
gba -> rbp
gbb -> sow
gbc -> npx
gbd -> enc
gbe -> jmh
gbf -> vik
gbg -> wfc
gbh -> nvr
gbi -> dou
gbj -> byf
gbk -> uul
gbl -> rxu
gbm -> jnv
gbn -> ted
gbo -> izl
gbp -> tju
gbq -> dgj
gbr -> dua
gbs -> vio
gbt -> teq
gbu -> iku
gbv -> nys
gbw -> wzy
gbx -> hdb
gby -> xes
gbz -> zhb
gca -> bhh
gcb -> bko
gcc -> flr
gcd -> mwh
gce -> dzg
gcf -> zrn
gcg -> pmf
gch -> wws
gci -> ase
gcj -> asb
gck -> vct
gcl -> foi
gcm -> gen
gcn -> rsa
gco -> ysz
gcp -> koj
gcq -> ioh
gcr -> czu
gcs -> uff
gct -> hma
gcu -> aav
gcv -> xqq
gcw -> uux
gcx -> icr
gcy -> wip
gcz -> nmb
gda -> mft
gdb -> prd
gdc -> yry
gdd -> yfx
gde -> zja
gdf -> oxq
gdg -> fko
gdh -> yof
gdi -> cwc
gdj -> jmi
gdk -> ldn
gdl -> isk
gdm -> frg
gdn -> tdp
gdo -> jpl
gdp -> wjt
gdq -> mtk
gdr -> znz
gds -> ebi
gdt -> rts
gdu -> ttq
gdv -> gyq
gdw -> mlu
gdx -> upc
gdy -> xfu
gdz -> iaz
gea -> qrv
geb -> ryf
gec -> umv
ged -> oqi
gee -> nal
gef -> rrw
geg -> jgl
geh -> wvc
gei -> cyd
gej -> qtu
gek -> fsf
gel -> acf
gem -> vir
gen -> ila
geo -> aas
gep -> wnh
geq -> aee
ger -> hbv
ges -> igj
get -> psg
geu -> gja
gev -> qfn
gew -> xfh
gex -> wit
gey -> vfb
gez -> wiy
gfa -> jmg
gfb -> eov
gfc -> xgd
gfd -> fgb
gfe -> qef
gff -> dnn
gfg -> fej
gfh -> hif
gfi -> wcd
gfj -> due
gfk -> ojo
gfl -> uqs
gfm -> ayj
gfn -> dbk
gfo -> gmz
gfp -> tlf
gfq -> qon
gfr -> asm
gfs -> hwt
gft -> jty
gfu -> vyt
gfv -> pkj
gfw -> xuf
gfx -> npa
gfy -> wmx
gfz -> ifm
gga -> bsc
ggb -> tir
ggc -> spf
ggd -> uow
gge -> yqo
ggf -> zsg
ggg -> sxh
ggh -> vmj
ggi -> lkj
ggj -> wrk
ggk -> cbi
ggl -> kiw
ggm -> tcv
ggn -> rin
ggo -> qjc
ggp -> utq
ggq -> fgn
ggr -> irf
ggs -> xfg
ggt -> ymm
ggu -> agq
ggv -> xbr
ggw -> fjs
ggx -> bsf
ggy -> uav
ggz -> xzl
gha -> fyi
ghb -> yfp
ghc -> tyh
ghd -> ghc
ghe -> fjl
ghf -> ied
ghg -> mor
ghh -> yef
ghi -> xio
ghj -> wol
ghk -> hvf
ghl -> oaq
ghm -> vpd
ghn -> iag
gho -> lga
ghp -> obz
ghq -> lky
ghr -> tsx
ghs -> dwh
ght -> adq
ghu -> svo
ghv -> xek
ghw -> hes
ghx -> fuy
ghy -> aqx
ghz -> ocj
gia -> fbf
gib -> syq
gic -> fyt
gid -> neo
gie -> ejz
gif -> jay
gig -> ezs
gih -> ykp
gii -> keu
gij -> pyl
gik -> kxv
gil -> qky
gim -> xzb
gin -> pxh
gio -> smq
gip -> rjf
giq -> ntf
gir -> lko
gis -> gfq
git -> qfl
giu -> mji
giv -> ypy
giw -> boa
gix -> lqo
giy -> yvw
giz -> toy
gja -> wxx
gjb -> rem
gjc -> yhp
gjd -> sag
gje -> zzj
gjf -> fzl
gjg -> vbx
gjh -> vxk
gji -> elw
gjj -> whn
gjk -> wze
gjl -> ydn
gjm -> rcp
gjn -> dnw
gjo -> jhs
gjp -> zxa
gjq -> ecs
gjr -> smu
gjs -> yqx
gjt -> rrr
gju -> pme
gjv -> gri
gjw -> gjj
gjx -> lau
gjy -> ojm
gjz -> kiu
gka -> siu
gkb -> hai
gkc -> quz
gkd -> rps
gke -> ppo
gkf -> xyg
gkg -> hzv
gkh -> kww
gki -> wpi
gkj -> pjy
gkk -> lou
gkl -> jpy
gkm -> jkd
gkn -> oma
gko -> mgs
gkp -> yiz
gkq -> zyi
gkr -> hxh
gks -> gbo
gkt -> ews
gku -> kks
gkv -> hlg
gkw -> waz
gkx -> cpc
gky -> foy
gkz -> vte
gla -> unx
glb -> hsh
glc -> vcw
gld -> cai
gle -> jie
glf -> uom
glg -> ehj
glh -> nrx
gli -> lue
glj -> mjd
glk -> igp
gll -> pwj
glm -> bot
gln -> ren
glo -> sqm
glp -> xcj
glq -> tvw
glr -> uei
gls -> aqo
glt -> hyj
glu -> stw
glv -> tkm
glw -> lwe
glx -> dpc
gly -> tbb
glz -> mnq
gma -> kzu
gmb -> adn
gmc -> glo
gmd -> xkp
gme -> fft
gmf -> epr
gmg -> mez
gmh -> zdx
gmi -> xzc
gmj -> ohb
gmk -> uyu
gml -> ovv
gmm -> myz
gmn -> fzm
gmo -> vmy
gmp -> bqr
gmq -> lgu
gmr -> awa
gms -> hwe
gmt -> amj
gmu -> tla
gmv -> cto
gmw -> uml
gmx -> tis
gmy -> ntm
gmz -> quo
gna -> rti
gnb -> zty
gnc -> xbj
gnd -> bdo
gne -> itn
gnf -> zzd
gng -> pra
gnh -> dxf
gni -> uim
gnj -> qgk
gnk -> wrq
gnl -> ujw
gnm -> gon
gnn -> ayh
gno -> thb
gnp -> gcf
gnq -> abo
gnr -> ucb
gns -> pib
gnt -> jta
gnu -> fqv
gnv -> joa
gnw -> oog
gnx -> gfo
gny -> xgr
gnz -> srq
goa -> yej
gob -> bzy
goc -> wmz
god -> oli
goe -> nyd
gof -> fpn
gog -> dgl
goh -> tfg
goi -> pcf
goj -> lqy
gok -> gks
gol -> ftg
gom -> qyt
gon -> kea
goo -> vuc
gop -> uku
goq -> nwv
gor -> mdl
gos -> rtm
got -> osx
gou -> szu
gov -> puj
gow -> zsw
gox -> onq
goy -> wnc
goz -> nvk
gpa -> itw
gpb -> sko
gpc -> jdg
gpd -> kgv
gpe -> jtu
gpf -> udb
gpg -> dxd
gph -> qrh
gpi -> pqo
gpj -> pjf
gpk -> bpp
gpl -> vnc
gpm -> wbu
gpn -> vqk
gpo -> kyl
gpp -> eqi
gpq -> ypz
gpr -> anv
gps -> air
gpt -> pxk
gpu -> hmy
gpv -> rtp
gpw -> nkb
gpx -> afm
gpy -> mcq
gpz -> srp
gqa -> xsl
gqb -> bvo
gqc -> naw
gqd -> unz
gqe -> rdc
gqf -> aow
gqg -> eed
gqh -> ccf
gqi -> otr
gqj -> jtl
gqk -> tiu
gql -> eax
gqm -> wnk
gqn -> nfk
gqo -> uhh
gqp -> gyf
gqq -> wnn
gqr -> dwk
gqs -> mjc
gqt -> fnz
gqu -> zhk
gqv -> ceh
gqw -> xqw
gqx -> rtf
gqy -> ffg
gqz -> rrz
gra -> mwy
grb -> ivb
grc -> zdu
grd -> sjd
gre -> thm
grf -> mhq
grg -> kmi
grh -> lkr
gri -> bsr
grj -> qnf
grk -> ash
grl -> sim
grm -> jgq
grn -> ypc
gro -> tmo
grp -> lwm
grq -> kkx
grr -> fcb
grs -> sca
grt -> fzt
gru -> tss
grv -> bgx
grw -> trk
grx -> nsv
gry -> ejm
grz -> aoo
gsa -> gzm
gsb -> gyu
gsc -> kfx
gsd -> pnl
gse -> lgw
gsf -> nhi
gsg -> qgs
gsh -> ltv
gsi -> bdn
gsj -> njj
gsk -> jlt
gsl -> mrd
gsm -> udf
gsn -> kqm
gso -> igz
gsp -> lun
gsq -> wpg
gsr -> fxa
gss -> dan
gst -> wbn
gsu -> ndy
gsv -> lfr
gsw -> mug
gsx -> pth
gsy -> lba
gsz -> fvm
gta -> xxg
gtb -> yvy
gtc -> bqh
gtd -> tsh
gte -> cwo
gtf -> yfu
gtg -> iia
gth -> htq
gti -> usd
gtj -> lsd
gtk -> wxz
gtl -> cis
gtm -> vvs
gtn -> koc
gto -> acj
gtp -> vgc
gtq -> hxi
gtr -> fgr
gts -> iit
gtt -> ole
gtu -> nbn
gtv -> csp
gtw -> fyz
gtx -> cnw
gty -> bag
gtz -> lww
gua -> hgv
gub -> wzv
guc -> iff
gud -> tul
gue -> uod
guf -> gvk
gug -> ijy
guh -> nqx
gui -> dbq
guj -> ssy
guk -> qfr
gul -> wmg
gum -> zsh
gun -> pnu
guo -> gfs
gup -> gsy
guq -> obv
gur -> sfq
gus -> hhp
gut -> mqa
guu -> drj
guv -> cbg
guw -> vtz
gux -> upn
guy -> slc
guz -> pbf
gva -> gil
gvb -> yjz
gvc -> ygi
gvd -> ypt
gve -> tlx
gvf -> ton
gvg -> gml
gvh -> ths
gvi -> hth
gvj -> gxe
gvk -> mfd
gvl -> ddy
gvm -> wns
gvn -> uuy
gvo -> lye
gvp -> imx
gvq -> fro
gvr -> ovc
gvs -> sev
gvt -> bub
gvu -> pke
gvv -> mgk
gvw -> pwf
gvx -> lbp
gvy -> lyo
gvz -> njs
gwa -> crd
gwb -> kuc
gwc -> ikl
gwd -> qec
gwe -> yfo
gwf -> dia
gwg -> lin
gwh -> nco
gwi -> iuy
gwj -> sjv
gwk -> pmu
gwl -> bcb
gwm -> aai
gwn -> awk
gwo -> buy
gwp -> cui
gwq -> myh
gwr -> url
gws -> shl
gwt -> qwt
gwu -> kha
gwv -> lnk
gww -> paa
gwx -> yiy
gwy -> chy
gwz -> vwt
gxa -> bfd
gxb -> rbz
gxc -> qjs
gxd -> pfr
gxe -> hua
gxf -> bvl
gxg -> dsc
gxh -> agz
gxi -> ezp
gxj -> bxt
gxk -> hbr
gxl -> zkb
gxm -> pdt
gxn -> bqs
gxo -> cnz
gxp -> ips
gxq -> aob
gxr -> vss
gxs -> xrz
gxt -> gnd
gxu -> rkf
gxv -> ncq
gxw -> fqr
gxx -> xst
gxy -> yhb
gxz -> lna
gya -> rxl
gyb -> hls
gyc -> wio
gyd -> ocd
gye -> mjx
gyf -> zye
gyg -> hti
gyh -> hga
gyi -> lbt
gyj -> pzc
gyk -> tnr
gyl -> qil
gym -> gkr
gyn -> sjq
gyo -> zkp
gyp -> acw
gyq -> lta
gyr -> okh
gys -> sph
gyt -> ghv
gyu -> mly
gyv -> oec
gyw -> ffi
gyx -> rhi
gyy -> zbz
gyz -> fvt
gza -> eik
gzb -> yzr
gzc -> tib
gzd -> dkr
gze -> yin
gzf -> ipp
gzg -> wul
gzh -> olo
gzi -> jhb
gzj -> iet
gzk -> ccj
gzl -> few
gzm -> gwq
gzn -> rbm
gzo -> mlx
gzp -> lmb
gzq -> nxm
gzr -> siv
gzs -> rat
gzt -> jls
gzu -> mzh
gzv -> dyl
gzw -> jia
gzx -> nin
gzy -> fih
gzz -> knz
haa -> hki
hab -> cld
hac -> sht
had -> gse
hae -> ftz
haf -> pmx
hag -> hip
hah -> huv
hai -> jkx
haj -> xdq
hak -> dij
hal -> bmj
ham -> mpx
han -> cow
hao -> kuv
hap -> bli
haq -> nwx
har -> njx
has -> cer
hat -> hou
hau -> vwk
hav -> cak
haw -> poc
hax -> fse
hay -> vku
haz -> iwu
hba -> yht
hbb -> wva
hbc -> uty
hbd -> ear
hbe -> ptd
hbf -> rqs
hbg -> pre
hbh -> ljl
hbi -> uip
hbj -> tql
hbk -> hdy
hbl -> zil
hbm -> bna
hbn -> rdd
hbo -> nfz
hbp -> wpk
hbq -> gfv
hbr -> viw
hbs -> iid
hbt -> qwp
hbu -> cpw
hbv -> rvk
hbw -> aoh
hbx -> rpj
hby -> uef
hbz -> imy
hca -> vfd
hcb -> mri
hcc -> xbe
hcd -> vzh
hce -> noz
hcf -> vhz
hcg -> dve
hch -> bvs
hci -> mks
hcj -> urb
hck -> bes
hcl -> qth
hcm -> zro
hcn -> saa
hco -> olk
hcp -> rpp
hcq -> kte
hcr -> pfo
hcs -> gio
hct -> pzy
hcu -> mbe
hcv -> azs
hcw -> hhs
hcx -> lru
hcy -> vsi
hcz -> abw
hda -> agc
hdb -> bxk
hdc -> dtg
hdd -> kyq
hde -> kcz
hdf -> qcg
hdg -> bmc
hdh -> suw
hdi -> hsi
hdj -> vys
hdk -> npu
hdl -> crc
hdm -> ekp
hdn -> jhe
hdo -> qtp
hdp -> ecb
hdq -> fug
hdr -> xhg
hds -> kuw
hdt -> pnt
hdu -> qki
hdv -> egu
hdw -> cso
hdx -> mjl
hdy -> qub
hdz -> qmp
hea -> ktp
heb -> rit
hec -> xim
hed -> jlb
hee -> ytf
hef -> okv
heg -> yxm
heh -> yfy
hei -> haj
hej -> hex
hek -> cnr
hel -> dvq
hem -> sgb
hen -> mwz
heo -> kpu
hep -> ayp
heq -> yan
her -> hbd
hes -> aie
het -> emf
heu -> ouz
hev -> zie
hew -> lgi
hex -> hir
hey -> ijx
hez -> net
hfa -> hvv
hfb -> wfa
hfc -> zru
hfd -> udj
hfe -> dxk
hff -> rig
hfg -> xjq
hfh -> kdy
hfi -> ywu
hfj -> pum
hfk -> kgy
hfl -> jhk
hfm -> glh
hfn -> dip
hfo -> pfz
hfp -> lgd
hfq -> xqj
hfr -> jqg
hfs -> viz
hft -> uvm
hfu -> iiu
hfv -> oac
hfw -> knw
hfx -> ivn
hfy -> nqn
hfz -> dul
hga -> ist
hgb -> wec
hgc -> ohg
hgd -> pvj
hge -> tfn
hgf -> vhy
hgg -> taa
hgh -> akc
hgi -> khw
hgj -> phb
hgk -> pao
hgl -> xto
hgm -> gwb
hgn -> aqy
hgo -> zkj
hgp -> tlq
hgq -> udy
hgr -> hlu
hgs -> upe
hgt -> tim
hgu -> yub
hgv -> wrn
hgw -> hoe
hgx -> eum
hgy -> pjt
hgz -> rqk
hha -> bfc
hhb -> ntd
hhc -> nmj
hhd -> jml
hhe -> ppa
hhf -> rxj
hhg -> raf
hhh -> pkc
hhi -> qpp
hhj -> kfk
hhk -> cdl
hhl -> hfl
hhm -> jvm
hhn -> nxc
hho -> fgl
hhp -> hze
hhq -> ehf
hhr -> jjh
hhs -> qjh
hht -> kxa
hhu -> lkb
hhv -> xcy
hhw -> yio
hhx -> xme
hhy -> jqx
hhz -> opx
hia -> qdu
hib -> cja
hic -> dza
hid -> zwh
hie -> juy
hif -> wxq
hig -> ahr
hih -> uic
hii -> szp
hij -> crv
hik -> lke
hil -> idg
him -> vqu
hin -> lcr
hio -> akj
hip -> wli
hiq -> lyi
hir -> wqi
his -> pgm
hit -> cvo
hiu -> rbd
hiv -> jln
hiw -> fnx
hix -> ywy
hiy -> fkx
hiz -> aov
hja -> cbr
hjb -> ush
hjc -> mce
hjd -> zqi
hje -> itx
hjf -> jtk
hjg -> znn
hjh -> gzs
hji -> yxy
hjj -> lwk
hjk -> nje
hjl -> lar
hjm -> rew
hjn -> xql
hjo -> smb
hjp -> sby
hjq -> lgs
hjr -> qho
hjs -> bbc
hjt -> uya
hju -> zgt
hjv -> ssl
hjw -> lry
hjx -> mjt
hjy -> cuo
hjz -> tfs
hka -> kos
hkb -> mir
hkc -> apr
hkd -> blx
hke -> evx
hkf -> cpg
hkg -> qzh
hkh -> mxu
hki -> urj
hkj -> kxc
hkk -> hhh
hkl -> gma
hkm -> mdq
hkn -> gcz
hko -> axa
hkp -> nye
hkq -> ham
hkr -> ecl
hks -> dao
hkt -> xkw
hku -> wzt
hkv -> jzi
hkw -> fof
hkx -> fap
hky -> kml
hkz -> wjk
hla -> liv
hlb -> qcx
hlc -> hde
hld -> gkf
hle -> laq
hlf -> qss
hlg -> amg
hlh -> vyj
hli -> zqa
hlj -> xvu
hlk -> hpz
hll -> vrv
hlm -> sxf
hln -> xga
hlo -> wqx
hlp -> osg
hlq -> oex
hlr -> mby
hls -> gce
hlt -> bkj
hlu -> cgu
hlv -> mkp
hlw -> lmq
hlx -> lwb
hly -> qlc
hlz -> iwa
hma -> eme
hmb -> jlh
hmc -> egh
hmd -> esd
hme -> lon
hmf -> ifr
hmg -> rer
hmh -> jhx
hmi -> nyt
hmj -> rxy
hmk -> beo
hml -> ycf
hmm -> yxa
hmn -> wyl
hmo -> nsn
hmp -> ewh
hmq -> hzw
hmr -> enh
hms -> dfw
hmt -> dit
hmu -> bjk
hmv -> yyz
hmw -> gyz
hmx -> tpp
hmy -> kxx
hmz -> wpu
hna -> nzx
hnb -> wka
hnc -> oev
hnd -> ymy
hne -> rlb
hnf -> gsw
hng -> mqs
hnh -> ymh
hni -> apz
hnj -> sqd
hnk -> qcy
hnl -> inr
hnm -> wjv
hnn -> fna
hno -> fmw
hnp -> wia
hnq -> lso
hnr -> vpe
hns -> jgs
hnt -> vep
hnu -> nkq
hnv -> pkw
hnw -> htx
hnx -> kyb
hny -> fuc
hnz -> fqo
hoa -> tyk
hob -> hjo
hoc -> vti
hod -> izf
hoe -> wbx
hof -> afi
hog -> rvn
hoh -> hqs
hoi -> xpi
hoj -> xab
hok -> kfd
hol -> eag
hom -> vby
hon -> hwy
hoo -> vsh
hop -> vue
hoq -> uiq
hor -> enr
hos -> yuk
hot -> wpz
hou -> nry
hov -> aka
how -> yop
hox -> nbt
hoy -> uqz
hoz -> kaw
hpa -> qlx
hpb -> ihi
hpc -> cae
hpd -> aoz
hpe -> hkr
hpf -> fvd
hpg -> mjq
hph -> bhw
hpi -> zmi
hpj -> yze
hpk -> gkd
hpl -> hhn
hpm -> sfp
hpn -> frd
hpo -> tnn
hpp -> ttp
hpq -> luq
hpr -> ocv
hps -> hdd
hpt -> gqk
hpu -> ipm
hpv -> nxi
hpw -> yhy
hpx -> flp
hpy -> uiw
hpz -> gpf
hqa -> rre
hqb -> ufg
hqc -> avl
hqd -> khv
hqe -> ggg
hqf -> gis
hqg -> ato
hqh -> rby
hqi -> pks
hqj -> rxx
hqk -> xmz
hql -> lyg
hqm -> spb
hqn -> zdn
hqo -> ove
hqp -> ckm
hqq -> wyo
hqr -> qle
hqs -> gzc
hqt -> fnk
hqu -> kca
hqv -> qyf
hqw -> svz
hqx -> klp
hqy -> ccv
hqz -> lzd
hra -> esi
hrb -> lyv
hrc -> xgp
hrd -> kde
hre -> vkt
hrf -> qwd
hrg -> kih
hrh -> vcr
hri -> sad
hrj -> djm
hrk -> tqk
hrl -> ovf
hrm -> sup
hrn -> asr
hro -> wed
hrp -> jgk
hrq -> lpb
hrr -> zfd
hrs -> dll
hrt -> hcl
hru -> mbj
hrv -> nho
hrw -> lyu
hrx -> hhe
hry -> vax
hrz -> cgi
hsa -> zhv
hsb -> kus
hsc -> zdj
hsd -> oxf
hse -> xkv
hsf -> tti
hsg -> ova
hsh -> ads
hsi -> opn
hsj -> opj
hsk -> mgi
hsl -> hct
hsm -> wqv
hsn -> oab
hso -> dmy
hsp -> qbm
hsq -> cyc
hsr -> tap
hss -> zyb
hst -> olh
hsu -> noy
hsv -> ntv
hsw -> tto
hsx -> uzp
hsy -> bwk
hsz -> wsf
hta -> xar
htb -> pql
htc -> wrz
htd -> qkd
hte -> wsi
htf -> oau
htg -> szx
hth -> sdp
hti -> ilj
htj -> txu
htk -> qac
htl -> fgd
htm -> auf
htn -> uvp
hto -> kvh
htp -> lzt
htq -> zfw
htr -> ote
hts -> cmw
htt -> ccx
htu -> nwc
htv -> qjt
htw -> kii
htx -> rrs
hty -> sqe
htz -> qpd
hua -> ghw
hub -> fax
huc -> kry
hud -> kvo
hue -> rbe
huf -> huy
hug -> xkf
huh -> wjh
hui -> cen
huj -> sem
huk -> qbd
hul -> jwh
hum -> nfw
hun -> zaf
huo -> wik
hup -> vle
huq -> kyp
hur -> jrq
hus -> pqn
hut -> pgw
huu -> cnx
huv -> oah
huw -> toh
hux -> olw
huy -> eex
huz -> spv
hva -> jum
hvb -> gmx
hvc -> ped
hvd -> dor
hve -> msh
hvf -> nhe
hvg -> pfw
hvh -> yyo
hvi -> ytc
hvj -> kfg
hvk -> err
hvl -> kum
hvm -> yxw
hvn -> qvb
hvo -> dfn
hvp -> ehb
hvq -> fyg
hvr -> rbs
hvs -> gcj
hvt -> hzz
hvu -> sya
hvv -> grh
hvw -> rim
hvx -> kjt
hvy -> pfv
hvz -> aca
hwa -> oai
hwb -> tli
hwc -> ycd
hwd -> owg
hwe -> gxc
hwf -> naf
hwg -> lxc
hwh -> rjd
hwi -> tmh
hwj -> ccr
hwk -> kqb
hwl -> wxg
hwm -> ipr
hwn -> kcr
hwo -> qdj
hwp -> spj
hwq -> lia
hwr -> vcu
hws -> smm
hwt -> mfl
hwu -> pem
hwv -> fha
hww -> zic
hwx -> kbz
hwy -> msm
hwz -> hys
hxa -> nxq
hxb -> zaq
hxc -> djz
hxd -> szb
hxe -> efj
hxf -> ptf
hxg -> lqg
hxh -> sne
hxi -> cny
hxj -> wqh
hxk -> ncs
hxl -> bet
hxm -> fte
hxn -> eue
hxo -> xav
hxp -> fou
hxq -> blg
hxr -> qzo
hxs -> ksj
hxt -> kgg
hxu -> uhr
hxv -> imf
hxw -> dlm
hxx -> fbc
hxy -> itu
hxz -> rnh
hya -> ukw
hyb -> tws
hyc -> vkr
hyd -> wsb
hye -> toq
hyf -> hyf
hyg -> yrt
hyh -> ymg
hyi -> bwp
hyj -> cmc
hyk -> big
hyl -> clv
hym -> ktn
hyn -> cze
hyo -> rlp
hyp -> rrm
hyq -> ctr
hyr -> jos
hys -> fam
hyt -> lgn
hyu -> ppr
hyv -> gda
hyw -> scc
hyx -> tvk
hyy -> fmr
hyz -> tyc
hza -> ckc
hzb -> qvd
hzc -> tbp
hzd -> nbm
hze -> amk
hzf -> iwn
hzg -> hng
hzh -> bun
hzi -> koe
hzj -> jhw
hzk -> emr
hzl -> iem
hzm -> ryj
hzn -> mqy
hzo -> lek
hzp -> pik
hzq -> tqp
hzr -> kug
hzs -> uew
hzt -> bxl
hzu -> bwi
hzv -> mtm
hzw -> agw
hzx -> wsy
hzy -> cud
hzz -> hqv
iaa -> dqk
iab -> tmt
iac -> ile
iad -> zhy
iae -> cqt
iaf -> ytd
iag -> qvz
iah -> ywg
iai -> obq
iaj -> tso
iak -> xbn
ial -> xfb
iam -> zlf
ian -> pxy
iao -> ykc
iap -> hpp
iaq -> lfp
iar -> bor
ias -> uwr
iat -> aqt
iau -> gvy
iav -> asd
iaw -> phr
iax -> bdx
iay -> sre
iaz -> xom
iba -> ory
ibb -> wzz
ibc -> nlt
ibd -> ins
ibe -> rxc
ibf -> aqj
ibg -> xgs
ibh -> vbj
ibi -> gpo
ibj -> krg
ibk -> kjr
ibl -> njl
ibm -> lbs
ibn -> cao
ibo -> sqa
ibp -> byz
ibq -> tqs
ibr -> gbu
ibs -> vcc
ibt -> okk
ibu -> bnr
ibv -> xjm
ibw -> kpd
ibx -> hrq
iby -> fyf
ibz -> ydc
ica -> ezw
icb -> vrk
icc -> bgi
icd -> agx
ice -> dac
icf -> xlb
icg -> dxi
ich -> mfm
ici -> rve
icj -> pno
ick -> abl
icl -> gab
icm -> ypm
icn -> zyz
ico -> cya
icp -> lyb
icq -> irh
icr -> gzf
ics -> jbg
ict -> jiq
icu -> nja
icv -> mos
icw -> utp
icx -> jkr
icy -> ies
icz -> rdy
ida -> gvn
idb -> knx
idc -> zpx
idd -> fuh
ide -> edn
idf -> wuh
idg -> ado
idh -> mti
idi -> zgd
idj -> eym
idk -> wrg
idl -> xfi
idm -> tgx
idn -> spn
ido -> vyf
idp -> aaj
idq -> obo
idr -> pdu
ids -> dmn
idt -> msr
idu -> gfi
idv -> hme
idw -> zik
idx -> mml
idy -> trt
idz -> bvc
iea -> xgc
ieb -> zxe
iec -> rhg
ied -> suk
iee -> chg
ief -> jgi
ieg -> qkv
ieh -> hds
iei -> amp
iej -> urz
iek -> xvw
iel -> xkd
iem -> xix
ien -> uem
ieo -> atw
iep -> wvq
ieq -> epn
ier -> yon
ies -> sov
iet -> cpt
ieu -> vkd
iev -> xrb
iew -> ees
iex -> yvj
iey -> fnq
iez -> pjw
ifa -> bcr
ifb -> ajd
ifc -> use
ifd -> okp
ife -> opm
iff -> hol
ifg -> eys
ifh -> uyi
ifi -> mcs
ifj -> tbj
ifk -> frj
ifl -> ocn
ifm -> boy
ifn -> xpb
ifo -> baf
ifp -> zns
ifq -> ppt
ifr -> beg
ifs -> bnw
ift -> frl
ifu -> lmj
ifv -> xsx
ifw -> iaf
ifx -> llm
ify -> ccz
ifz -> fbi
iga -> wks
igb -> bdz
igc -> yfh
igd -> gth
ige -> tbr
igf -> jus
igg -> wfb
igh -> ulv
igi -> luz
igj -> dir
igk -> eli
igl -> dfo
igm -> fgm
ign -> wxe
igo -> opd
igp -> jvr
igq -> wyk
igr -> mjo
igs -> ngt
igt -> rmi
igu -> rqf
igv -> qbh
igw -> lei
igx -> luy
igy -> aed
igz -> rac
iha -> fav
ihb -> otj
ihc -> nba
ihd -> ljz
ihe -> jvx
ihf -> rsz
ihg -> wfx
ihh -> nfx
ihi -> slz
ihj -> hxc
ihk -> ilc
ihl -> jny
ihm -> kyu
ihn -> aws
iho -> gkb
ihp -> vmm
ihq -> cye
ihr -> hyi
ihs -> kfz
iht -> ndz
ihu -> zeg
ihv -> ccu
ihw -> jyj
ihx -> zta
ihy -> jlw
ihz -> koa
iia -> cbm
iib -> lqn
iic -> axh
iid -> ekb
iie -> mmt
iif -> oyg
iig -> syv
iih -> hih
iii -> lvh
iij -> uhb
iik -> psp
iil -> hmu
iim -> adt
iin -> cfd
iio -> tqm
iip -> xzo
iiq -> ksn
iir -> qrl
iis -> sux
iit -> mpr
iiu -> edq
iiv -> txn
iiw -> avx
iix -> xnj
iiy -> hmx
iiz -> emq
ija -> cfw
ijb -> ddn
ijc -> wgd
ijd -> pwn
ije -> xeh
ijf -> bcm
ijg -> axq
ijh -> uio
iji -> hun
ijj -> kro
ijk -> iik
ijl -> wco
ijm -> bol
ijn -> ljr
ijo -> aaq
ijp -> shy
ijq -> rqi
ijr -> osv
ijs -> cpn
ijt -> cwr
iju -> rqw
ijv -> nge
ijw -> ajv
ijx -> ror
ijy -> inp
ijz -> tfv
ika -> dxy
ikb -> qay
ikc -> rhc
ikd -> nwh
ike -> aqc
ikf -> arg
ikg -> nni
ikh -> lsb
iki -> nxg
ikj -> sru
ikk -> wri
ikl -> ref
ikm -> elx
ikn -> fpe
iko -> jik
ikp -> ntk
ikq -> srk
ikr -> kxu
iks -> rna
ikt -> fyd
iku -> mgj
ikv -> ifv
ikw -> ixc
ikx -> dzw
iky -> kib
ikz -> vfp
ila -> wlu
ilb -> kcj
ilc -> ozz
ild -> tgk
ile -> siw
ilf -> poe
ilg -> drb
ilh -> bpk
ili -> cov
ilj -> icw
ilk -> ngv
ill -> zrr
ilm -> aif
iln -> ysa
ilo -> kmd
ilp -> cdk
ilq -> dse
ilr -> cyj
ils -> nti
ilt -> ygm
ilu -> kjq
ilv -> owu
ilw -> rxr
ilx -> ljn
ily -> tlw
ilz -> boo
ima -> amn
imb -> ytu
imc -> hdx
imd -> rbb
ime -> ddk
imf -> axf
img -> hmo
imh -> ric
imi -> dgm
imj -> mmb
imk -> wag
iml -> bku
imm -> yhk
imn -> yky
imo -> vnz
imp -> nfl
imq -> aha
imr -> mht
ims -> krl
imt -> qve
imu -> xnl
imv -> nvq
imw -> uht
imx -> miw
imy -> huf
imz -> rxq
ina -> kee
inb -> xxz
inc -> czy
ind -> jmp
ine -> peu
inf -> ili
ing -> zvq
inh -> dpx
ini -> vkh
inj -> jzh
ink -> wie
inl -> kvs
inm -> lot
inn -> ofv
ino -> awl
inp -> zcd
inq -> vbh
inr -> iqf
ins -> bfw
int -> psm
inu -> rye
inv -> aet
inw -> tcc
inx -> fvk
iny -> ojb
inz -> lvj
ioa -> zca
iob -> xfe
ioc -> qoy
iod -> gpx
ioe -> xxk
iof -> mvp
iog -> mnx
ioh -> ubd
ioi -> cyg
ioj -> rdu
iok -> syl
iol -> pps
iom -> jrz
ion -> pjz
ioo -> stp
iop -> igo
ioq -> pya
ior -> lme
ios -> ftj
iot -> yip
iou -> ast
iov -> eru
iow -> brp
iox -> xiu
ioy -> uae
ioz -> tfc
ipa -> cne
ipb -> xhw
ipc -> qau
ipd -> nvs
ipe -> hvj
ipf -> apw
ipg -> eqz
iph -> bqm
ipi -> bde
ipj -> afw
ipk -> hem
ipl -> ykb
ipm -> odr
ipn -> ywt
ipo -> wft
ipp -> lae
ipq -> kxq
ipr -> kve
ips -> efg
ipt -> eco
ipu -> rks
ipv -> egs
ipw -> psf
ipx -> bpo
ipy -> zfl
ipz -> tsm
iqa -> wql
iqb -> glk
iqc -> zff
iqd -> jew
iqe -> fpv
iqf -> lvg
iqg -> dex
iqh -> yiw
iqi -> izt
iqj -> wui
iqk -> qym
iql -> eng
iqm -> kfe
iqn -> dbz
iqo -> ugc
iqp -> duj
iqq -> rzx
iqr -> ibg
iqs -> zbq
iqt -> mxx
iqu -> tth
iqv -> slx
iqw -> kck
iqx -> ovk
iqy -> lmo
iqz -> osd
ira -> agi
irb -> djc
irc -> zmy
ird -> dmc
ire -> vbw
irf -> dpb
irg -> ugu
irh -> nnv
iri -> uoc
irj -> xxx
irk -> htv
irl -> jsf
irm -> hhy
irn -> rmo
iro -> rqx
irp -> aye
irq -> tag
irr -> rmk
irs -> exl
irt -> bxc
iru -> nql
irv -> icf
irw -> azx
irx -> hzt
iry -> vcd
irz -> mih
isa -> nep
isb -> xmt
isc -> doy
isd -> zko
ise -> qip
isf -> gcu
isg -> ubm
ish -> mki
isi -> ysv
isj -> mfw
isk -> ved
isl -> fvn
ism -> hku
isn -> ylm
iso -> txv
isp -> zwr
isq -> cbu
isr -> bgs
iss -> top
ist -> dlq
isu -> rbu
isv -> rwk
isw -> pbz
isx -> eje
isy -> qkp
isz -> hza
ita -> oue
itb -> ywl
itc -> aek
itd -> akq
ite -> avk
itf -> ymz
itg -> eph
ith -> rli
iti -> joo
itj -> stk
itk -> nha
itl -> mta
itm -> qui
itn -> eqk
ito -> ieh
itp -> sln
itq -> bbt
itr -> jcz
its -> rnt
itt -> eor
itu -> lxb
itv -> esm
itw -> uob
itx -> adb
ity -> pid
itz -> udr
iua -> odc
iub -> php
iuc -> yic
iud -> exj
iue -> zme
iuf -> ktg
iug -> ahm
iuh -> hsd
iui -> ewp
iuj -> grg
iuk -> ogj
iul -> lhj
ium -> qwv
iun -> zun
iuo -> cls
iup -> jbz
iuq -> hrt
iur -> zvi
ius -> yzk
iut -> edf
iuu -> qoe
iuv -> ilz
iuw -> cou
iux -> cuw
iuy -> vxw
iuz -> xjp
iva -> zml
ivb -> wwr
ivc -> cuu
ivd -> dzj
ive -> zhd
ivf -> wkl
ivg -> hnv
ivh -> mfs
ivi -> dyx
ivj -> sge
ivk -> cvs
ivl -> kzi
ivm -> anm
ivn -> fpg
ivo -> llf
ivp -> xii
ivq -> sbw
ivr -> wtj
ivs -> odl
ivt -> aks
ivu -> zcj
ivv -> twy
ivw -> sjn
ivx -> jfe
ivy -> ybr
ivz -> vyo
iwa -> luu
iwb -> nyq
iwc -> rcy
iwd -> ypa
iwe -> mhe
iwf -> kct
iwg -> cag
iwh -> cqa
iwi -> scr
iwj -> waq
iwk -> qcs
iwl -> moq
iwm -> nqj
iwn -> rlf
iwo -> ztv
iwp -> cyb
iwq -> hdf
iwr -> nad
iws -> zvs
iwt -> qtj
iwu -> hbb
iwv -> psw
iww -> qfk
iwx -> jbp
iwy -> swv
iwz -> iao
ixa -> kjl
ixb -> mku
ixc -> jsk
ixd -> yxs
ixe -> kbq
ixf -> zay
ixg -> bcn
ixh -> wgs
ixi -> fek
ixj -> mnp
ixk -> hvz
ixl -> xkl
ixm -> ffu
ixn -> asu
ixo -> gif
ixp -> vny
ixq -> esn
ixr -> neb
ixs -> qan
ixt -> edh
ixu -> jzz
ixv -> znt
ixw -> bfi
ixx -> jma
ixy -> qiy
ixz -> zwl
iya -> aho
iyb -> gfx
iyc -> bwr
iyd -> qwy
iye -> djg
iyf -> mno
iyg -> rqe
iyh -> deh
iyi -> cbv
iyj -> sjc
iyk -> dai
iyl -> jvp
iym -> uga
iyn -> nlo
iyo -> fom
iyp -> igy
iyq -> ksb
iyr -> eyn
iys -> vxe
iyt -> dmx
iyu -> gwi
iyv -> gol
iyw -> sjk
iyx -> tvx
iyy -> war
iyz -> xev
iza -> gas
izb -> gux
izc -> txz
izd -> bxe
ize -> jme
izf -> ctw
izg -> xht
izh -> gij
izi -> dgv
izj -> rwe
izk -> fhx
izl -> per
izm -> trw
izn -> akt
izo -> zvu
izp -> fls
izq -> mgl
izr -> trp
izs -> flb
izt -> ljf
izu -> zxs
izv -> fxf
izw -> ink
izx -> tml
izy -> nev
izz -> fsm
jaa -> nxk
jab -> ohd
jac -> sve
jad -> yig
jae -> wke
jaf -> vds
jag -> psq
jah -> bbb
jai -> gpi
jaj -> gqi
jak -> cla
jal -> tei
jam -> ois
jan -> mlz
jao -> lxq
jap -> pyq
jaq -> rsk
jar -> hbk
jas -> cwi
jat -> rpn
jau -> jfm
jav -> tzj
jaw -> dkx
jax -> ybo
jay -> cjz
jaz -> lkc
jba -> olb
jbb -> gwz
jbc -> tgr
jbd -> qls
jbe -> bit
jbf -> gkc
jbg -> xcb
jbh -> lzn
jbi -> gqj
jbj -> spu
jbk -> gus
jbl -> akk
jbm -> gwc
jbn -> kkh
jbo -> qaf
jbp -> gkm
jbq -> aem
jbr -> jbn
jbs -> gqt
jbt -> fsu
jbu -> fve
jbv -> voa
jbw -> wej
jbx -> anl
jby -> ztw
jbz -> mgn
jca -> odh
jcb -> kiv
jcc -> nzs
jcd -> fnd
jce -> nsb
jcf -> ljw
jcg -> htk
jch -> xrq
jci -> xan
jcj -> qvs
jck -> fjo
jcl -> ssa
jcm -> eiz
jcn -> eef
jco -> ujt
jcp -> bys
jcq -> wok
jcr -> vic
jcs -> hni
jct -> ysk
jcu -> qrs
jcv -> ynr
jcw -> bjj
jcx -> ewj
jcy -> jfk
jcz -> idf
jda -> wgi
jdb -> dba
jdc -> obs
jdd -> iua
jde -> izp
jdf -> ejd
jdg -> pfc
jdh -> dkt
jdi -> ncz
jdj -> pba
jdk -> seg
jdl -> nkx
jdm -> rio
jdn -> xid
jdo -> kmt
jdp -> bjo
jdq -> vqb
jdr -> opz
jds -> xma
jdt -> euq
jdu -> jst
jdv -> wmy
jdw -> pwo
jdx -> euo
jdy -> esp
jdz -> gny
jea -> lti
jeb -> chb
jec -> szl
jed -> duv
jee -> mdx
jef -> ill
jeg -> ywm
jeh -> mue
jei -> ern
jej -> oxp
jek -> yll
jel -> xvg
jem -> vzj
jen -> afv
jeo -> vuu
jep -> bia
jeq -> eqc
jer -> xuo
jes -> okc
jet -> wro
jeu -> kcx
jev -> qfh
jew -> mli
jex -> ntp
jey -> oaj
jez -> orz
jfa -> gua
jfb -> nbh
jfc -> ptb
jfd -> lam
jfe -> rwy
jff -> cob
jfg -> tqd
jfh -> lfv
jfi -> upw
jfj -> xuv
jfk -> nit
jfl -> urr
jfm -> ujv
jfn -> cgc
jfo -> mka
jfp -> dwa
jfq -> kqz
jfr -> ltb
jfs -> wkz
jft -> lwf
jfu -> rwq
jfv -> nbg
jfw -> oik
jfx -> wut
jfy -> yce
jfz -> pvk
jga -> tjr
jgb -> yma
jgc -> etv
jgd -> uke
jge -> wdn
jgf -> uxb
jgg -> cbb
jgh -> lkw
jgi -> uag
jgj -> wte
jgk -> dnr
jgl -> tvm
jgm -> qst
jgn -> ikn
jgo -> znm
jgp -> tua
jgq -> jzd
jgr -> xjr
jgs -> phn
jgt -> kgr
jgu -> lhu
jgv -> ebm
jgw -> xve
jgx -> wiu
jgy -> fzv
jgz -> qts
jha -> xnv
jhb -> pou
jhc -> ifq
jhd -> xzf
jhe -> plm
jhf -> cbo
jhg -> omu
jhh -> oza
jhi -> vmh
jhj -> mzo
jhk -> iwo
jhl -> xby
jhm -> qja
jhn -> rlg
jho -> mbo
jhp -> gbz
jhq -> qji
jhr -> sbu
jhs -> dso
jht -> kao
jhu -> dnd
jhv -> oeq
jhw -> zyl
jhx -> qpe
jhy -> kmo
jhz -> lgg
jia -> sbc
jib -> vdy
jic -> nci
jid -> zrq
jie -> skk
jif -> ctu
jig -> xum
jih -> kjk
jii -> bzr
jij -> tlr
jik -> cod
jil -> qoz
jim -> lsf
jin -> cyp
jio -> ldu
jip -> yfi
jiq -> reh
jir -> uwf
jis -> mpl
jit -> lah
jiu -> lfd
jiv -> jrd
jiw -> svy
jix -> tjv
jiy -> pmm
jiz -> vro
jja -> tde
jjb -> uts
jjc -> bxr
jjd -> bal
jje -> rao
jjf -> uej
jjg -> iqb
jjh -> otf
jji -> oll
jjj -> jmy
jjk -> vha
jjl -> deq
jjm -> djp
jjn -> qpx
jjo -> uxw
jjp -> jlg
jjq -> ucr
jjr -> yuy
jjs -> tqo
jjt -> ztk
jju -> mve
jjv -> xjy
jjw -> mrf
jjx -> tmw
jjy -> fpr
jjz -> nes
jka -> sco
jkb -> npw
jkc -> yvr
jkd -> ymq
jke -> nok
jkf -> pqu
jkg -> agm
jkh -> cnk
jki -> pnk
jkj -> jtr
jkk -> xul
jkl -> fxu
jkm -> eac
jkn -> wzs
jko -> jtg
jkp -> sba
jkq -> imj
jkr -> oot
jks -> tog
jkt -> yyk
jku -> cyn
jkv -> qmo
jkw -> ylu
jkx -> xoz
jky -> suj
jkz -> uqy
jla -> mep
jlb -> ltm
jlc -> zpi
jld -> geu
jle -> ihm
jlf -> ome
jlg -> ppg
jlh -> aar
jli -> uah
jlj -> smh
jlk -> dxq
jll -> fwb
jlm -> xbk
jln -> tba
jlo -> puh
jlp -> ugz
jlq -> otv
jlr -> tms
jls -> vwo
jlt -> uwc
jlu -> alx
jlv -> krj
jlw -> cgo
jlx -> avy
jly -> vuz
jlz -> mtf
jma -> ovu
jmb -> ddq
jmc -> zpf
jmd -> mke
jme -> ldg
jmf -> hiv
jmg -> szj
jmh -> ekt
jmi -> tmg
jmj -> wvl
jmk -> ygb
jml -> uhn
jmm -> hcy
jmn -> dhr
jmo -> caa
jmp -> vip
jmq -> thc
jmr -> pln
jms -> mhu
jmt -> zpu
jmu -> uuk
jmv -> lpu
jmw -> bjd
jmx -> zom
jmy -> iar
jmz -> bkm
jna -> dft
jnb -> lvs
jnc -> auv
jnd -> bft
jne -> yfv
jnf -> uif
jng -> ixi
jnh -> dzs
jni -> feq
jnj -> vpl
jnk -> eht
jnl -> slh
jnm -> pqh
jnn -> ycg
jno -> dmh
jnp -> xwi
jnq -> fdm
jnr -> uea
jns -> qrd
jnt -> uyd
jnu -> wse
jnv -> nud
jnw -> azh
jnx -> qqp
jny -> gxx
jnz -> twt
joa -> fwh
job -> yok
joc -> wbq
jod -> koo
joe -> kmx
jof -> iqg
jog -> dqw
joh -> fab
joi -> ydi
joj -> vjk
jok -> ldr
jol -> nvo
jom -> wjr
jon -> fjw
joo -> kbo
jop -> kzs
joq -> thk
jor -> hvn
jos -> dlw
jot -> vsk
jou -> tjq
jov -> ssm
jow -> crn
jox -> nmo
joy -> iah
joz -> ocq
jpa -> eqa
jpb -> tol
jpc -> hrn
jpd -> irq
jpe -> ybz
jpf -> tdv
jpg -> usp
jph -> vfc
jpi -> res
jpj -> nsy
jpk -> qhr
jpl -> dax
jpm -> hsy
jpn -> ued
jpo -> wne
jpp -> isf
jpq -> mua
jpr -> xhh
jps -> coa
jpt -> cbz
jpu -> viq
jpv -> uyh
jpw -> ppc
jpx -> wfj
jpy -> tfu
jpz -> ywz
jqa -> gpj
jqb -> pgu
jqc -> zah
jqd -> cpf
jqe -> fpi
jqf -> xhj
jqg -> izk
jqh -> ngg
jqi -> mwc
jqj -> irz
jqk -> fca
jql -> fil
jqm -> nke
jqn -> mea
jqo -> ufw
jqp -> jug
jqq -> fdp
jqr -> yqk
jqs -> lxl
jqt -> nae
jqu -> fhe
jqv -> dwd
jqw -> jxd
jqx -> ydv
jqy -> box
jqz -> tbt
jra -> lbi
jrb -> hvl
jrc -> aou
jrd -> jnz
jre -> ntn
jrf -> lln
jrg -> rlu
jrh -> ple
jri -> gcy
jrj -> yzg
jrk -> lll
jrl -> oea
jrm -> aso
jrn -> kju
jro -> qam
jrp -> qde
jrq -> sbp
jrr -> cgd
jrs -> ivu
jrt -> krt
jru -> lxk
jrv -> uap
jrw -> nby
jrx -> lss
jry -> qdq
jrz -> cbk
jsa -> ksg
jsb -> sqg
jsc -> ype
jsd -> qoj
jse -> zkq
jsf -> ute
jsg -> bkw
jsh -> scn
jsi -> ums
jsj -> hmd
jsk -> lsw
jsl -> wrv
jsm -> ulb
jsn -> htb
jso -> kru
jsp -> ftx
jsq -> qcn
jsr -> ldh
jss -> anx
jst -> rxp
jsu -> ahp
jsv -> vky
jsw -> bqd
jsx -> nea
jsy -> cfs
jsz -> qdo
jta -> jvk
jtb -> oiq
jtc -> xzm
jtd -> gbg
jte -> ajj
jtf -> nsc
jtg -> mov
jth -> hxo
jti -> dcr
jtj -> gjb
jtk -> wxd
jtl -> add
jtm -> azv
jtn -> zqr
jto -> nwl
jtp -> wqb
jtq -> usl
jtr -> hor
jts -> ozv
jtt -> ucn
jtu -> sdy
jtv -> bfp
jtw -> wnu
jtx -> lhy
jty -> psj
jtz -> buj
jua -> vop
jub -> bzz
juc -> tcr
jud -> glg
jue -> kul
juf -> liu
jug -> znl
juh -> wcl
jui -> cvk
juj -> nsz
juk -> hcb
jul -> wtw
jum -> kmh
jun -> ewq
juo -> cxx
jup -> axk
juq -> ymw
jur -> fwq
jus -> try
jut -> eci
juu -> wtb
juv -> gej
juw -> snj
jux -> zpg
juy -> tch
juz -> xpd
jva -> qza
jvb -> aue
jvc -> wca
jvd -> noo
jve -> arl
jvf -> psk
jvg -> cfm
jvh -> flk
jvi -> rjl
jvj -> hiz
jvk -> bql
jvl -> tpg
jvm -> edr
jvn -> qga
jvo -> pen
jvp -> oar
jvq -> btc
jvr -> cgv
jvs -> rxk
jvt -> uxu
jvu -> vbr
jvv -> trd
jvw -> tqa
jvx -> vib
jvy -> rkh
jvz -> ptx
jwa -> qrc
jwb -> fwt
jwc -> mkh
jwd -> cna
jwe -> vfu
jwf -> uhd
jwg -> sak
jwh -> esz
jwi -> jda
jwj -> tlj
jwk -> oft
jwl -> fma
jwm -> nmi
jwn -> pyn
jwo -> ysg
jwp -> xbc
jwq -> mzl
jwr -> hpi
jws -> qjf
jwt -> xpz
jwu -> cvt
jwv -> cdh
jww -> qjz
jwx -> myy
jwy -> fws
jwz -> wme
jxa -> xbt
jxb -> bjr
jxc -> str
jxd -> zki
jxe -> soy
jxf -> ccd
jxg -> mbm
jxh -> wad
jxi -> mng
jxj -> btg
jxk -> hjy
jxl -> ibt
jxm -> eid
jxn -> oam
jxo -> fkd
jxp -> jph
jxq -> lzg
jxr -> uyb
jxs -> kxg
jxt -> izo
jxu -> hxj
jxv -> utm
jxw -> nao
jxx -> gfz
jxy -> mgm
jxz -> eak
jya -> vcy
jyb -> ftb
jyc -> goj
jyd -> xeu
jye -> pzj
jyf -> szc
jyg -> pqv
jyh -> tsw
jyi -> jmz
jyj -> zop
jyk -> ttc
jyl -> mxa
jym -> buk
jyn -> sou
jyo -> ywo
jyp -> hpy
jyq -> tqy
jyr -> kqe
jys -> rle
jyt -> fdk
jyu -> jbv
jyv -> uju
jyw -> bfu
jyx -> dum
jyy -> azr
jyz -> jgb
jza -> ztb
jzb -> cte
jzc -> bxs
jzd -> cxl
jze -> bus
jzf -> zbt
jzg -> skt
jzh -> jtf
jzi -> zjh
jzj -> qsv
jzk -> tgi
jzl -> dye
jzm -> xtl
jzn -> vnw
jzo -> abt
jzp -> zkm
jzq -> dhi
jzr -> ywv
jzs -> tww
jzt -> pts
jzu -> kfc
jzv -> kil
jzw -> xtv
jzx -> dfu
jzy -> zlc
jzz -> eyv
kaa -> scd
kab -> xbo
kac -> opl
kad -> lxv
kae -> jbt
kaf -> ytr
kag -> fts
kah -> gyc
kai -> kev
kaj -> jzr
kak -> iya
kal -> xke
kam -> plf
kan -> uhv
kao -> eok
kap -> evj
kaq -> mpa
kar -> aon
kas -> png
kat -> hwm
kau -> ufv
kav -> ule
kaw -> nfi
kax -> aly
kay -> tfd
kaz -> stm
kba -> khf
kbb -> jdp
kbc -> bns
kbd -> cam
kbe -> kku
kbf -> dtj
kbg -> paw
kbh -> ocz
kbi -> ccl
kbj -> erd
kbk -> ymk
kbl -> elp
kbm -> skl
kbn -> wqs
kbo -> xhi
kbp -> ttd
kbq -> psv
kbr -> fcw
kbs -> ihj
kbt -> wnq
kbu -> vry
kbv -> ndq
kbw -> ogp
kbx -> zuk
kby -> veq
kbz -> zfo
kca -> dsp
kcb -> cey
kcc -> zwa
kcd -> izu
kce -> nrw
kcf -> hji
kcg -> pfj
kch -> pab
kci -> aam
kcj -> woc
kck -> xdo
kcl -> zzp
kcm -> zwe
kcn -> nrk
kco -> hdu
kcp -> rsp
kcq -> jem
kcr -> jrv
kcs -> gqc
kct -> cca
kcu -> dbd
kcv -> pqd
kcw -> whw
kcx -> hcp
kcy -> ktz
kcz -> loz
kda -> ftc
kdb -> vkq
kdc -> frn
kdd -> exi
kde -> qch
kdf -> cks
kdg -> kta
kdh -> oqb
kdi -> uus
kdj -> fvg
kdk -> odu
kdl -> wjl
kdm -> pij
kdn -> kmk
kdo -> ftd
kdp -> cme
kdq -> sxm
kdr -> exs
kds -> hjx
kdt -> wyr
kdu -> pue
kdv -> ugr
kdw -> xrh
kdx -> moo
kdy -> mrp
kdz -> jnh
kea -> ssg
keb -> fzr
kec -> yme
ked -> vdl
kee -> vpn
kef -> xot
keg -> xij
keh -> ewx
kei -> qob
kej -> oif
kek -> sax
kel -> edk
kem -> uqo
ken -> xgf
keo -> svr
kep -> eun
keq -> dku
ker -> ssz
kes -> ngl
ket -> mrc
keu -> bxx
kev -> ljx
kew -> vsr
kex -> woj
key -> hfu
kez -> tix
kfa -> kse
kfb -> ibb
kfc -> ofw
kfd -> shb
kfe -> fkl
kff -> dje
kfg -> olp
kfh -> hlp
kfi -> jmj
kfj -> gbl
kfk -> zyv
kfl -> nji
kfm -> ctc
kfn -> uol
kfo -> ebe
kfp -> hnu
kfq -> gjd
kfr -> heq
kfs -> rxw
kft -> cnm
kfu -> ljd
kfv -> pdn
kfw -> vvp
kfx -> wyv
kfy -> npd
kfz -> akn
kga -> tmi
kgb -> xfr
kgc -> erf
kgd -> qqh
kge -> hew
kgf -> zno
kgg -> ubz
kgh -> lvf
kgi -> zsn
kgj -> nwd
kgk -> qhq
kgl -> pdy
kgm -> vhv
kgn -> lrs
kgo -> hau
kgp -> bat
kgq -> pap
kgr -> hky
kgs -> vdb
kgt -> boc
kgu -> mva
kgv -> yro
kgw -> kxz
kgx -> dyu
kgy -> pwy
kgz -> kfm
kha -> hdc
khb -> qcw
khc -> uuh
khd -> oad
khe -> nqm
khf -> pxb
khg -> nwg
khh -> idl
khi -> pol
khj -> qrx
khk -> smt
khl -> hgo
khm -> wsn
khn -> cqb
kho -> ett
khp -> bcw
khq -> wra
khr -> vgf
khs -> fwf
kht -> vkk
khu -> ydj
khv -> htz
khw -> bso
khx -> nhx
khy -> jbu
khz -> imn
kia -> xbd
kib -> znp
kic -> wcv
kid -> kbw
kie -> kzd
kif -> ckl
kig -> elv
kih -> pxu
kii -> woe
kij -> hcf
kik -> qgv
kil -> mvz
kim -> mxv
kin -> jvv
kio -> hul
kip -> bdf
kiq -> ger
kir -> ltf
kis -> dkc
kit -> tbz
kiu -> dsw
kiv -> lid
kiw -> uee
kix -> lgv
kiy -> ehu
kiz -> kqu
kja -> otk
kjb -> kht
kjc -> yra
kjd -> cug
kje -> iwg
kjf -> zes
kjg -> nru
kjh -> lpk
kji -> guz
kjj -> smp
kjk -> xtd
kjl -> ury
kjm -> ahq
kjn -> wpy
kjo -> nia
kjp -> byc
kjq -> kqq
kjr -> unu
kjs -> fdf
kjt -> brr
kju -> tzk
kjv -> cjg
kjw -> tgg
kjx -> ehm
kjy -> zqd
kjz -> hsf
kka -> pvy
kkb -> eky
kkc -> pqb
kkd -> ivq
kke -> zej
kkf -> umb
kkg -> khr
kkh -> ebu
kki -> wlr
kkj -> jbb
kkk -> csx
kkl -> pru
kkm -> iyk
kkn -> lmk
kko -> svv
kkp -> htp
kkq -> pse
kkr -> sut
kks -> zin
kkt -> tgs
kku -> orb
kkv -> yrf
kkw -> lql
kkx -> rom
kky -> ecc
kkz -> fzs
kla -> dwz
klb -> qvg
klc -> rct
kld -> gul
kle -> hwq
klf -> bis
klg -> ebg
klh -> xee
kli -> ujz
klj -> hkq
klk -> eja
kll -> mzk
klm -> ria
kln -> agk
klo -> zee
klp -> kty
klq -> kwu
klr -> yzp
kls -> rjz
klt -> lxm
klu -> fol
klv -> bdi
klw -> gnb
klx -> jrs
kly -> pie
klz -> lfb
kma -> hub
kmb -> wab
kmc -> ges
kmd -> vll
kme -> ays
kmf -> wpj
kmg -> tdq
kmh -> pja
kmi -> esu
kmj -> nun
kmk -> zpj
kml -> zuj
kmm -> gve
kmn -> vxd
kmo -> oeh
kmp -> rhn
kmq -> azm
kmr -> kyc
kms -> xbx
kmt -> yna
kmu -> nbk
kmv -> vtk
kmw -> gbm
kmx -> gfn
kmy -> zpr
kmz -> tha
kna -> dkz
knb -> lmf
knc -> egj
knd -> gsc
kne -> dvr
knf -> kkq
kng -> cpl
knh -> xru
kni -> qiv
knj -> yth
knk -> uci
knl -> iwe
knm -> ztf
knn -> hjj
kno -> tds
knp -> heb
knq -> twh
knr -> aeu
kns -> fjb
knt -> nwj
knu -> bvm
knv -> edj
knw -> wib
knx -> iic
kny -> gkv
knz -> hvc
koa -> enz
kob -> und
koc -> itj
kod -> zyg
koe -> zfa
kof -> wau
kog -> vil
koh -> hju
koi -> mzj
koj -> vrx
kok -> mmv
kol -> qmt
kom -> eut
kon -> bov
koo -> lbh
kop -> lsr
koq -> hlv
kor -> mbp
kos -> dfs
kot -> fjq
kou -> sgw
kov -> wht
kow -> jee
kox -> aox
koy -> vff
koz -> jnn
kpa -> iib
kpb -> aau
kpc -> bek
kpd -> xjn
kpe -> etr
kpf -> myb
kpg -> nda
kph -> mrt
kpi -> vsx
kpj -> tkx
kpk -> mkj
kpl -> hfr
kpm -> qzt
kpn -> vok
kpo -> mac
kpp -> uog
kpq -> hof
kpr -> gtm
kps -> eny
kpt -> amc
kpu -> dog
kpv -> ait
kpw -> fdw
kpx -> ztn
kpy -> jvo
kpz -> rlr
kqa -> qdd
kqb -> ryc
kqc -> kcq
kqd -> jav
kqe -> abx
kqf -> imb
kqg -> vac
kqh -> vsa
kqi -> qvc
kqj -> fsq
kqk -> uoi
kql -> bga
kqm -> gnj
kqn -> pta
kqo -> lqf
kqp -> fmn
kqq -> tkc
kqr -> hqt
kqs -> abs
kqt -> wct
kqu -> pcj
kqv -> oyc
kqw -> urw
kqx -> hup
kqy -> siz
kqz -> jak
kra -> xss
krb -> scm
krc -> gep
krd -> fsp
kre -> clp
krf -> dtp
krg -> xoe
krh -> nqv
kri -> bir
krj -> pqx
krk -> kzg
krl -> ijm
krm -> yks
krn -> xoj
kro -> jxv
krp -> eib
krq -> sci
krr -> kjx
krs -> tps
krt -> ukv
kru -> oqh
krv -> suf
krw -> rjj
krx -> tzu
kry -> crf
krz -> fog
ksa -> jax
ksb -> geo
ksc -> fie
ksd -> ueo
kse -> wlf
ksf -> yhz
ksg -> uls
ksh -> ukk
ksi -> nsg
ksj -> vet
ksk -> cnq
ksl -> exv
ksm -> ydm
ksn -> ylz
kso -> tia
ksp -> uuv
ksq -> tdr
ksr -> hgb
kss -> ydq
kst -> idz
ksu -> zrf
ksv -> ddp
ksw -> fcq
ksx -> cgm
ksy -> asp
ksz -> ats
kta -> xyc
ktb -> djw
ktc -> fvl
ktd -> oqp
kte -> pot
ktf -> nhg
ktg -> sgr
kth -> yqu
kti -> niu
ktj -> heg
ktk -> tgf
ktl -> cbe
ktm -> agh
ktn -> nbl
kto -> byj
ktp -> zzx
ktq -> rrv
ktr -> tts
kts -> ajl
ktt -> mfv
ktu -> unv
ktv -> zeh
ktw -> bfz
ktx -> etl
kty -> vfo
ktz -> ggw
kua -> pbr
kub -> hge
kuc -> aqm
kud -> bqq
kue -> nym
kuf -> ymt
kug -> lwa
kuh -> xnt
kui -> btx
kuj -> van
kuk -> gxu
kul -> fqw
kum -> zju
kun -> kyd
kuo -> vfk
kup -> trr
kuq -> qiq
kur -> dqc
kus -> jzu
kut -> bhv
kuu -> frv
kuv -> sef
kuw -> mqr
kux -> zll
kuy -> kgp
kuz -> pcu
kva -> xhk
kvb -> qsm
kvc -> akh
kvd -> jna
kve -> xhu
kvf -> afe
kvg -> urv
kvh -> zbu
kvi -> zza
kvj -> gxg
kvk -> gki
kvl -> nek
kvm -> crb
kvn -> ipb
kvo -> zlo
kvp -> ptq
kvq -> uij
kvr -> lbx
kvs -> zky
kvt -> rhr
kvu -> ivo
kvv -> tsg
kvw -> fnj
kvx -> qud
kvy -> tbq
kvz -> doa
kwa -> dxr
kwb -> loy
kwc -> yny
kwd -> tmb
kwe -> mon
kwf -> acu
kwg -> aoq
kwh -> vmd
kwi -> idn
kwj -> epf
kwk -> awu
kwl -> huk
kwm -> yoq
kwn -> eki
kwo -> sqy
kwp -> fga
kwq -> frx
kwr -> pyg
kws -> cqy
kwt -> vfe
kwu -> lqa
kwv -> ako
kww -> ewl
kwx -> gbs
kwy -> mye
kwz -> hvr
kxa -> fss
kxb -> zkg
kxc -> dpt
kxd -> fjm
kxe -> azd
kxf -> wpf
kxg -> ccg
kxh -> bzu
kxi -> kql
kxj -> xqi
kxk -> cgj
kxl -> qld
kxm -> vqq
kxn -> pso
kxo -> zaa
kxp -> yam
kxq -> thg
kxr -> ujs
kxs -> ocl
kxt -> yjj
kxu -> nfh
kxv -> xgb
kxw -> ppm
kxx -> ulq
kxy -> iva
kxz -> xqk
kya -> bei
kyb -> qmk
kyc -> ymj
kyd -> lfa
kye -> egl
kyf -> irn
kyg -> tlv
kyh -> jbj
kyi -> dii
kyj -> nme
kyk -> rog
kyl -> wci
kym -> igd
kyn -> fon
kyo -> lml
kyp -> cch
kyq -> jro
kyr -> egc
kys -> fnr
kyt -> mxw
kyu -> rpw
kyv -> qwl
kyw -> oid
kyx -> keg
kyy -> nam
kyz -> jxr
kza -> qkh
kzb -> zup
kzc -> mla
kzd -> lby
kze -> map
kzf -> upb
kzg -> hvp
kzh -> ozo
kzi -> wju
kzj -> tzd
kzk -> mls
kzl -> ihy
kzm -> yoh
kzn -> iiy
kzo -> qsq
kzp -> zct
kzq -> wwk
kzr -> iwj
kzs -> sys
kzt -> udz
kzu -> orp
kzv -> dgk
kzw -> oib
kzx -> dbh
kzy -> qzc
kzz -> are
laa -> lhb
lab -> ybu
lac -> dsi
lad -> mkd
lae -> ugb
laf -> prv
lag -> pzz
lah -> axp
lai -> wmq
laj -> gly
lak -> mje
lal -> uun
lam -> ajt
lan -> gkp
lao -> cjw
lap -> nbu
laq -> bzn
lar -> gtg
las -> gea
lat -> wan
lau -> apt
lav -> ogl
law -> vhc
lax -> eej
lay -> ucq
laz -> wyw
lba -> ens
lbb -> zyc
lbc -> sdv
lbd -> ivw
lbe -> etm
lbf -> czf
lbg -> igc
lbh -> amq
lbi -> txe
lbj -> gjv
lbk -> bme
lbl -> fhb
lbm -> qzj
lbn -> zgs
lbo -> xdv
lbp -> fqm
lbq -> grf
lbr -> rlt
lbs -> omv
lbt -> vtt
lbu -> ibm
lbv -> dhu
lbw -> yvk
lbx -> vkb
lby -> gqd
lbz -> zeo
lca -> ebz
lcb -> gvt
lcc -> rlk
lcd -> xqr
lce -> uvb
lcf -> tnx
lcg -> fmz
lch -> vsz
lci -> paz
lcj -> nnp
lck -> qmm
lcl -> kzm
lcm -> vtp
lcn -> vis
lco -> tzr
lcp -> lqk
lcq -> tbw
lcr -> ubi
lcs -> ryb
lct -> pct
lcu -> bdt
lcv -> vog
lcw -> hhm
lcx -> ues
lcy -> bct
lcz -> zxq
lda -> ahb
ldb -> imh
ldc -> peh
ldd -> vrd
lde -> rzv
ldf -> pww
ldg -> zrm
ldh -> dwo
ldi -> jil
ldj -> gxo
ldk -> mcd
ldl -> dro
ldm -> ixk
ldn -> lsy
ldo -> pms
ldp -> rab
ldq -> pfq
ldr -> hfo
lds -> gtv
ldt -> hjv
ldu -> kbj
ldv -> wvd
ldw -> kko
ldx -> vus
ldy -> jxq
ldz -> prr
lea -> nkg
leb -> fwc
lec -> glf
led -> umm
lee -> cuc
lef -> wyj
leg -> fnw
leh -> rxs
lei -> vig
lej -> elm
lek -> alk
lel -> ejw
lem -> dqd
len -> oyu
leo -> vth
lep -> oks
leq -> oho
ler -> fzk
les -> cin
let -> ssk
leu -> qxz
lev -> zqq
lew -> jjp
lex -> dvo
ley -> dcn
lez -> stj
lfa -> toc
lfb -> lov
lfc -> fhn
lfd -> wwa
lfe -> xze
lff -> uwj
lfg -> jvy
lfh -> qjy
lfi -> hrb
lfj -> tlh
lfk -> ngo
lfl -> cty
lfm -> pim
lfn -> vwb
lfo -> nmh
lfp -> usf
lfq -> pbh
lfr -> fpp
lfs -> qel
lft -> gxf
lfu -> qql
lfv -> zku
lfw -> rcj
lfx -> pkz
lfy -> rgo
lfz -> tfx
lga -> umg
lgb -> bnv
lgc -> uri
lgd -> leh
lge -> prx
lgf -> wfu
lgg -> wgh
lgh -> pep
lgi -> zle
lgj -> zsr
lgk -> wiz
lgl -> fai
lgm -> gsr
lgn -> ogb
lgo -> xhq
lgp -> htw
lgq -> tuo
lgr -> nqo
lgs -> wmc
lgt -> ryy
lgu -> ytw
lgv -> kuh
lgw -> kof
lgx -> stf
lgy -> jnm
lgz -> uvw
lha -> zqg
lhb -> hve
lhc -> heu
lhd -> wds
lhe -> qmx
lhf -> fbe
lhg -> lct
lhh -> nsu
lhi -> cuf
lhj -> ont
lhk -> qbe
lhl -> zqt
lhm -> jsi
lhn -> cvz
lho -> imu
lhp -> tlb
lhq -> yaq
lhr -> cll
lhs -> qzr
lht -> vwz
lhu -> tsp
lhv -> pzb
lhw -> udk
lhx -> zwm
lhy -> ceu
lhz -> ggq
lia -> szv
lib -> lnw
lic -> nac
lid -> xsw
lie -> xbs
lif -> wnb
lig -> mah
lih -> qba
lii -> czi
lij -> rde
lik -> ock
lil -> vzm
lim -> osr
lin -> oio
lio -> efb
lip -> vwy
liq -> ubb
lir -> gyy
lis -> zax
lit -> rsg
liu -> dvs
liv -> yho
liw -> hfq
lix -> bqj
liy -> hcn
liz -> evm
lja -> znc
ljb -> fxi
ljc -> erq
ljd -> evf
lje -> ivt
ljf -> hvg
ljg -> qur
ljh -> hxl
lji -> stl
ljj -> att
ljk -> efd
ljl -> lup
ljm -> znq
ljn -> cxq
ljo -> xmm
ljp -> ara
ljq -> dtt
ljr -> owp
ljs -> jxp
ljt -> amy
lju -> olr
ljv -> vjs
ljw -> exg
ljx -> hqm
ljy -> rhy
ljz -> mdm
lka -> zje
lkb -> smo
lkc -> mhd
lkd -> ool
lke -> lve
lkf -> qqt
lkg -> yqe
lkh -> nxy
lki -> tcl
lkj -> yqr
lkk -> mhr
lkl -> kwe
lkm -> xog
lkn -> qrb
lko -> dsj
lkp -> aua
lkq -> qnk
lkr -> udo
lks -> jah
lkt -> lev
lku -> rsc
lkv -> cmn
lkw -> vxo
lkx -> yii
lky -> abn
lkz -> byr
lla -> blb
llb -> hnb
llc -> zts
lld -> clf
lle -> usi
llf -> wdw
llg -> kth
llh -> icg
lli -> rwv
llj -> hxf
llk -> cwz
lll -> rph
llm -> cwy
lln -> svq
llo -> tpa
llp -> zen
llq -> eer
llr -> dhb
lls -> feu
llt -> nqu
llu -> zpo
llv -> hnl
llw -> egy
llx -> ffz
lly -> qwb
llz -> cmt
lma -> iii
lmb -> pls
lmc -> yap
lmd -> jwc
lme -> rir
lmf -> vwg
lmg -> cuk
lmh -> vof
lmi -> rlz
lmj -> nzc
lmk -> ilb
lml -> jfw
lmm -> gmn
lmn -> kvp
lmo -> bnp
lmp -> bqv
lmq -> mny
lmr -> nyk
lms -> hnn
lmt -> bwd
lmu -> jif
lmv -> jdb
lmw -> mzc
lmx -> rtz
lmy -> ddm
lmz -> erc
lna -> fso
lnb -> kor
lnc -> ydb
lnd -> jqi
lne -> spt
lnf -> tlp
lng -> cpa
lnh -> snx
lni -> jbc
lnj -> xrk
lnk -> een
lnl -> kge
lnm -> gfh
lnn -> nra
lno -> euj
lnp -> cim
lnq -> xda
lnr -> kkz
lns -> pqa
lnt -> srf
lnu -> hql
lnv -> jwy
lnw -> oqz
lnx -> duh
lny -> aix
lnz -> mkc
loa -> vps
lob -> wdm
loc -> axl
lod -> aey
loe -> ldd
lof -> xou
log -> mlk
loh -> vnv
loi -> tnw
loj -> bsu
lok -> lkd
lol -> dhx
lom -> egi
lon -> ykd
loo -> aii
lop -> urq
loq -> oba
lor -> uyc
los -> hpr
lot -> mvg
lou -> znw
lov -> wou
low -> skn
lox -> ayo
loy -> klj
loz -> fky
lpa -> tnh
lpb -> fmo
lpc -> sfv
lpd -> yla
lpe -> qbp
lpf -> ntj
lpg -> giq
lph -> anh
lpi -> nei
lpj -> nuh
lpk -> srz
lpl -> xoo
lpm -> cgz
lpn -> hss
lpo -> ttl
lpp -> hiw
lpq -> ybc
lpr -> emy
lps -> wot
lpt -> myu
lpu -> etf
lpv -> ssr
lpw -> qvw
lpx -> ojn
lpy -> qqz
lpz -> zxo
lqa -> jze
lqb -> ukg
lqc -> xyd
lqd -> ffo
lqe -> wei
lqf -> shw
lqg -> nvd
lqh -> sqh
lqi -> aan
lqj -> sao
lqk -> uuj
lql -> mna
lqm -> bwo
lqn -> zxj
lqo -> iop
lqp -> wjj
lqq -> bfh
lqr -> oki
lqs -> xea
lqt -> hpt
lqu -> ucg
lqv -> vpz
lqw -> jqy
lqx -> yni
lqy -> ndj
lqz -> qmz
lra -> qvy
lrb -> ezt
lrc -> ddg
lrd -> vnm
lre -> pkd
lrf -> hat
lrg -> tet
lrh -> ppb
lri -> bkz
lrj -> vkw
lrk -> ias
lrl -> hqr
lrm -> lhx
lrn -> iso
lro -> xcn
lrp -> drp
lrq -> xut
lrr -> vgb
lrs -> ghy
lrt -> mek
lru -> jwf
lrv -> uvs
lrw -> mtt
lrx -> vfr
lry -> uqg
lrz -> itr
lsa -> syx
lsb -> dfi
lsc -> otq
lsd -> kjf
lse -> nxf
lsf -> jxc
lsg -> gjm
lsh -> nky
lsi -> ytn
lsj -> gwp
lsk -> mpe
lsl -> cyw
lsm -> egk
lsn -> fqy
lso -> boq
lsp -> fhl
lsq -> bsj
lsr -> apb
lss -> zkf
lst -> pyk
lsu -> ily
lsv -> cjk
lsw -> weh
lsx -> cbw
lsy -> bmg
lsz -> bzc
lta -> spd
ltb -> eyp
ltc -> gym
ltd -> zha
lte -> kaf
ltf -> wea
ltg -> pto
lth -> lao
lti -> spr
ltj -> imm
ltk -> bcj
ltl -> ahe
ltm -> gnk
ltn -> kqv
lto -> btk
ltp -> xkq
ltq -> nfm
ltr -> ryv
lts -> vzq
ltt -> rju
ltu -> alo
ltv -> mpn
ltw -> riz
ltx -> wlx
lty -> yas
ltz -> cpk
lua -> xlk
lub -> gbq
luc -> hlo
lud -> xjz
lue -> stc
luf -> fqq
lug -> dlf
luh -> kcm
lui -> ooj
luj -> uuo
luk -> ayx
lul -> jjk
lum -> vox
lun -> eve
luo -> fco
lup -> qcz
luq -> iou
lur -> dgg
lus -> hps
lut -> hyd
luu -> met
luv -> xbh
luw -> fdt
lux -> qgd
luy -> iwi
luz -> mrk
lva -> rrl
lvb -> ukf
lvc -> anc
lvd -> qtr
lve -> qii
lvf -> yhq
lvg -> hjq
lvh -> kyf
lvi -> yoj
lvj -> kcy
lvk -> esf
lvl -> tuw
lvm -> quv
lvn -> wgu
lvo -> mxn
lvp -> lmt
lvq -> rjn
lvr -> sxr
lvs -> pri
lvt -> ksk
lvu -> glq
lvv -> kjd
lvw -> pvo
lvx -> ztx
lvy -> drq
lvz -> qrg
lwa -> mlf
lwb -> hje
lwc -> xfa
lwd -> ewz
lwe -> ycj
lwf -> fkg
lwg -> uve
lwh -> izz
lwi -> xqg
lwj -> ygj
lwk -> nlv
lwl -> ehd
lwm -> uvo
lwn -> rki
lwo -> jxo
lwp -> tnc
lwq -> jzb
lwr -> dpn
lws -> hqo
lwt -> jrn
lwu -> ujn
lwv -> yvt
lww -> iax
lwx -> tkv
lwy -> yxk
lwz -> ezb
lxa -> tyy
lxb -> jxa
lxc -> wox
lxd -> zks
lxe -> rmp
lxf -> fsx
lxg -> arr
lxh -> fod
lxi -> thu
lxj -> prg
lxk -> okm
lxl -> ymx
lxm -> fuu
lxn -> cfx
lxo -> vkc
lxp -> bdu
lxq -> msl
lxr -> hxu
lxs -> mpd
lxt -> xyw
lxu -> gig
lxv -> svw
lxw -> nhu
lxx -> emn
lxy -> tqz
lxz -> slu
lya -> nul
lyb -> vrz
lyc -> jjf
lyd -> yac
lye -> cgk
lyf -> nax
lyg -> yot
lyh -> rtn
lyi -> aes
lyj -> mbt
lyk -> tjh
lyl -> knl
lym -> mod
lyn -> gmg
lyo -> xjs
lyp -> wof
lyq -> kld
lyr -> rgp
lys -> pce
lyt -> vpf
lyu -> tjm
lyv -> wvh
lyw -> loa
lyx -> qhu
lyy -> aqv
lyz -> ohf
lza -> ogh
lzb -> pee
lzc -> hie
lzd -> kid
lze -> yga
lzf -> xlv
lzg -> mds
lzh -> faa
lzi -> cqu
lzj -> oti
lzk -> wyn
lzl -> def
lzm -> dky
lzn -> kkc
lzo -> yyc
lzp -> yvn
lzq -> qhw
lzr -> pha
lzs -> lhp
lzt -> byd
lzu -> jsc
lzv -> ihg
lzw -> jkc
lzx -> mwv
lzy -> szi
lzz -> gdn
maa -> jbh
mab -> njc
mac -> ceb
mad -> xzs
mae -> sju
maf -> rmv
mag -> oey
mah -> xfz
mai -> uez
maj -> ybn
mak -> onb
mal -> put
mam -> hdn
man -> xmv
mao -> cio
map -> uzs
maq -> knk
mar -> fno
mas -> trz
mat -> ooq
mau -> mnn
mav -> dzv
maw -> jlo
max -> urx
may -> bpt
maz -> owv
mba -> kox
mbb -> bly
mbc -> tfj
mbd -> zav
mbe -> fqa
mbf -> jnd
mbg -> wkn
mbh -> fnl
mbi -> jzy
mbj -> jhv
mbk -> rjm
mbl -> ajs
mbm -> thq
mbn -> srr
mbo -> las
mbp -> wtm
mbq -> hxr
mbr -> zor
mbs -> flm
mbt -> psy
mbu -> gud
mbv -> yln
mbw -> brc
mbx -> zyd
mby -> sbl
mbz -> xwo
mca -> jhj
mcb -> jbd
mcc -> fly
mcd -> bqo
mce -> ocg
mcf -> hom
mcg -> swl
mch -> npz
mci -> obn
mcj -> lqh
mck -> bdq
mcl -> rbn
mcm -> ouc
mcn -> fsi
mco -> egx
mcp -> oax
mcq -> pll
mcr -> zrx
mcs -> msb
mct -> ybj
mcu -> tme
mcv -> sks
mcw -> guq
mcx -> nnf
mcy -> hpw
mcz -> dny
mda -> iex
mdb -> ite
mdc -> koh
mdd -> xdx
mde -> hqi
mdf -> fgg
mdg -> dgi
mdh -> zyu
mdi -> wzo
mdj -> sii
mdk -> pkv
mdl -> wtp
mdm -> bac
mdn -> dko
mdo -> ohh
mdp -> dim
mdq -> jji
mdr -> zdp
mds -> chz
mdt -> bnb
mdu -> vns
mdv -> afp
mdw -> zii
mdx -> bza
mdy -> wth
mdz -> dhj
mea -> jrb
meb -> pfh
mec -> urp
med -> fpk
mee -> vkf
mef -> tax
meg -> zvy
meh -> nyc
mei -> njo
mej -> idq
mek -> aky
mel -> bmr
mem -> thw
men -> blk
meo -> wdz
mep -> tno
meq -> ssi
mer -> crg
mes -> ijp
met -> mlc
meu -> ihe
mev -> ptk
mew -> jhh
mex -> dwm
mey -> vul
mez -> eez
mfa -> jcc
mfb -> lwq
mfc -> pvz
mfd -> lem
mfe -> zvc
mff -> mvl
mfg -> qxk
mfh -> dfq
mfi -> kla
mfj -> zpd
mfk -> mmx
mfl -> kog
mfm -> xhn
mfn -> plj
mfo -> cno
mfp -> xlp
mfq -> jnk
mfr -> wbt
mfs -> jrc
mft -> ubc
mfu -> vcs
mfv -> czp
mfw -> jrm
mfx -> vnf
mfy -> irm
mfz -> ltq
mga -> peg
mgb -> opr
mgc -> lum
mgd -> iko
mge -> oxn
mgf -> lzi
mgg -> lvm
mgh -> fhi
mgi -> ipe
mgj -> bgk
mgk -> tca
mgl -> pwq
mgm -> gjk
mgn -> gwo
mgo -> qzk
mgp -> spe
mgq -> can
mgr -> eox
mgs -> pux
mgt -> bea
mgu -> ing
mgv -> gct
mgw -> cxw
mgx -> tjp
mgy -> aaz
mgz -> yif
mha -> djj
mhb -> ylk
mhc -> mnv
mhd -> sdn
mhe -> wfk
mhf -> esa
mhg -> rmb
mhh -> tka
mhi -> zsl
mhj -> ipx
mhk -> wuv
mhl -> bio
mhm -> vbd
mhn -> nkd
mho -> qto
mhp -> gbj
mhq -> wxv
mhr -> dat
mhs -> nas
mht -> kdr
mhu -> cwl
mhv -> lxd
mhw -> zgu
mhx -> ibi
mhy -> rlq
mhz -> opk
mia -> ipo
mib -> efy
mic -> zrl
mid -> yxo
mie -> qhx
mif -> oyr
mig -> tgw
mih -> qsj
mii -> qma
mij -> skd
mik -> bkr
mil -> uha
mim -> zzv
min -> ssq
mio -> liy
mip -> ukn
miq -> jmm
mir -> ysx
mis -> hjl
mit -> ngr
miu -> igu
miv -> nfr
miw -> wjx
mix -> xgj
miy -> pac
miz -> ezz
mja -> evt
mjb -> hyh
mjc -> upq
mjd -> jnf
mje -> brg
mjf -> pxf
mjg -> dkv
mjh -> kxj
mji -> gec
mjj -> lci
mjk -> faj
mjl -> jcv
mjm -> yur
mjn -> jed
mjo -> uhw
mjp -> kti
mjq -> vcl
mjr -> eke
mjs -> jeo
mjt -> vyp
mju -> vdr
mjv -> bgd
mjw -> ozc
mjx -> meu
mjy -> kbr
mjz -> dyp
mka -> dfk
mkb -> uak
mkc -> oeg
mkd -> nim
mke -> tro
mkf -> asa
mkg -> epd
mkh -> ocw
mki -> ymd
mkj -> biw
mkk -> kwm
mkl -> nfv
mkm -> vts
mkn -> usa
mko -> dqt
mkp -> qem
mkq -> xpn
mkr -> lqu
mks -> ltc
mkt -> pds
mku -> jrh
mkv -> sdg
mkw -> mrr
mkx -> tny
mky -> zur
mkz -> pfd
mla -> zeq
mlb -> tyj
mlc -> fhw
mld -> uhl
mle -> epq
mlf -> ihx
mlg -> cej
mlh -> xew
mli -> bvp
mlj -> uwl
mlk -> bgp
mll -> xqa
mlm -> qdg
mln -> gmt
mlo -> gmo
mlp -> qhv
mlq -> irg
mlr -> fba
mls -> xqm
mlt -> qdi
mlu -> qlf
mlv -> rno
mlw -> fag
mlx -> htg
mly -> ycy
mlz -> lwd
mma -> kur
mmb -> dzk
mmc -> lkg
mmd -> riw
mme -> wop
mmf -> nxj
mmg -> gbk
mmh -> cba
mmi -> ehy
mmj -> fdx
mmk -> ken
mml -> gwk
mmm -> pyf
mmn -> gcr
mmo -> dpf
mmp -> emc
mmq -> gre
mmr -> zue
mms -> fif
mmt -> wvm
mmu -> jdc
mmv -> rwm
mmw -> isu
mmx -> vtu
mmy -> rap
mmz -> qgc
mna -> vmn
mnb -> qbg
mnc -> nde
mnd -> xil
mne -> jjc
mnf -> tsj
mng -> ftr
mnh -> bjy
mni -> pgv
mnj -> nhn
mnk -> bnm
mnl -> msc
mnm -> cbx
mnn -> jgr
mno -> std
mnp -> zsq
mnq -> kow
mnr -> cjv
mns -> nbz
mnt -> gqz
mnu -> ngs
mnv -> qgf
mnw -> inn
mnx -> egd
mny -> spw
mnz -> xai
moa -> ovx
mob -> fwv
moc -> dbv
mod -> ipt
moe -> ckr
mof -> qko
mog -> kkv
moh -> dei
moi -> jeq
moj -> msx
mok -> mwa
mol -> plr
mom -> gcb
mon -> twq
moo -> oiv
mop -> fzy
moq -> tkq
mor -> uui
mos -> scq
mot -> qgx
mou -> ifg
mov -> rdw
mow -> riu
mox -> hxd
moy -> bxj
moz -> wzd
mpa -> pwd
mpb -> xxe
mpc -> wja
mpd -> ujg
mpe -> xmy
mpf -> iqt
mpg -> cxi
mph -> snm
mpi -> piz
mpj -> unh
mpk -> wlw
mpl -> wpc
mpm -> fuk
mpn -> jcl
mpo -> poh
mpp -> vxh
mpq -> rfx
mpr -> lyc
mps -> hby
mpt -> ght
mpu -> wbv
mpv -> dme
mpw -> kas
mpx -> mwd
mpy -> yod
mpz -> ggi
mqa -> jhn
mqb -> kvr
mqc -> thv
mqd -> fhc
mqe -> itk
mqf -> qkl
mqg -> mhk
mqh -> ncy
mqi -> gvc
mqj -> qny
mqk -> fjk
mql -> kon
mqm -> uzl
mqn -> vje
mqo -> whm
mqp -> fuw
mqq -> blj
mqr -> jwi
mqs -> kuj
mqt -> tjl
mqu -> rfo
mqv -> pah
mqw -> euu
mqx -> mnz
mqy -> nwa
mqz -> rnm
mra -> aoi
mrb -> ngw
mrc -> dbe
mrd -> xld
mre -> vxy
mrf -> yvu
mrg -> hjk
mrh -> yia
mri -> mcv
mrj -> iyj
mrk -> abk
mrl -> jyq
mrm -> fmu
mrn -> sfk
mro -> rcl
mrp -> ghm
mrq -> xxl
mrr -> spy
mrs -> kcw
mrt -> utj
mru -> dwg
mrv -> bmt
mrw -> afc
mrx -> uyt
mry -> fuz
mrz -> qeh
msa -> qri
msb -> yqs
msc -> bbf
msd -> jfq
mse -> mgx
msf -> xkx
msg -> tud
msh -> slt
msi -> qcb
msj -> zcg
msk -> fzf
msl -> izj
msm -> jcb
msn -> drf
mso -> luc
msp -> cev
msq -> wap
msr -> dlc
mss -> uxt
mst -> cmv
msu -> cxb
msv -> mfa
msw -> neq
msx -> wbc
msy -> bpf
msz -> euz
mta -> rzi
mtb -> odx
mtc -> caw
mtd -> rpz
mte -> lsx
mtf -> zbo
mtg -> cct
mth -> cnh
mti -> vdw
mtj -> yvm
mtk -> miu
mtl -> qar
mtm -> qpm
mtn -> lbb
mto -> xft
mtp -> qjb
mtq -> clk
mtr -> luf
mts -> zxx
mtt -> kwr
mtu -> haf
mtv -> ysj
mtw -> bxz
mtx -> kcg
mty -> odj
mtz -> uxp
mua -> cot
mub -> jve
muc -> iym
mud -> nwz
mue -> tln
muf -> wvf
mug -> mut
muh -> uqc
mui -> njn
muj -> sll
muk -> cek
mul -> rua
mum -> sgg
mun -> ffs
muo -> gik
mup -> hte
muq -> zhg
mur -> bvt
mus -> osy
mut -> sqp
muu -> bqa
muv -> pfn
muw -> rzk
mux -> bux
muy -> gyr
muz -> kar
mva -> mgq
mvb -> avu
mvc -> oaz
mvd -> rev
mve -> ver
mvf -> qjp
mvg -> zew
mvh -> exu
mvi -> upi
mvj -> soq
mvk -> nzz
mvl -> jwt
mvm -> fje
mvn -> fpl
mvo -> dxn
mvp -> rfb
mvq -> knb
mvr -> glw
mvs -> hkz
mvt -> uie
mvu -> ept
mvv -> szq
mvw -> rkt
mvx -> dpu
mvy -> ssd
mvz -> zds
mwa -> yke
mwb -> tqv
mwc -> ouy
mwd -> zps
mwe -> qvr
mwf -> aur
mwg -> egg
mwh -> feo
mwi -> eyu
mwj -> oox
mwk -> yog
mwl -> ycm
mwm -> dlh
mwn -> okd
mwo -> blf
mwp -> ktl
mwq -> lsi
mwr -> aaf
mws -> ecg
mwt -> iqj
mwu -> vlt
mwv -> lwj
mww -> lpc
mwx -> tsf
mwy -> wlj
mwz -> wpr
mxa -> lyl
mxb -> dxt
mxc -> eni
mxd -> deg
mxe -> vne
mxf -> xzy
mxg -> fzu
mxh -> als
mxi -> vca
mxj -> qti
mxk -> jdu
mxl -> inm
mxm -> bob
mxn -> lbk
mxo -> ooa
mxp -> pvs
mxq -> sjb
mxr -> udt
mxs -> auj
mxt -> rqr
mxu -> rfe
mxv -> glz
mxw -> hpo
mxx -> riy
mxy -> igx
mxz -> lfo
mya -> juo
myb -> hap
myc -> xkt
myd -> hpf
mye -> pxx
myf -> gim
myg -> yir
myh -> ptl
myi -> zfh
myj -> eee
myk -> pmq
myl -> eya
mym -> rtr
myn -> nqc
myo -> coi
myp -> zzi
myq -> oek
myr -> jau
mys -> ymv
myt -> edp
myu -> btq
myv -> oct
myw -> pew
myx -> mjw
myy -> nmf
myz -> gvd
mza -> jqz
mzb -> par
mzc -> vex
mzd -> awe
mze -> pnh
mzf -> ffn
mzg -> ixv
mzh -> yev
mzi -> urc
mzj -> vpq
mzk -> xdz
mzl -> csv
mzm -> isj
mzn -> tmx
mzo -> vmr
mzp -> bkl
mzq -> zba
mzr -> khb
mzs -> bul
mzt -> oni
mzu -> ddj
mzv -> baj
mzw -> ryi
mzx -> iqk
mzy -> wge
mzz -> lnt
naa -> luv
nab -> xbg
nac -> wcc
nad -> znr
nae -> ajc
naf -> qfa
nag -> cmk
nah -> kyz
nai -> eks
naj -> cra
nak -> uvj
nal -> ftv
nam -> dpy
nan -> nuj
nao -> dhz
nap -> ygk
naq -> dtk
nar -> snv
nas -> wfr
nat -> srh
nau -> mas
nav -> khx
naw -> hug
nax -> lrw
nay -> lto
naz -> ipu
nba -> xwj
nbb -> eqb
nbc -> lep
nbd -> hhv
nbe -> kop
nbf -> svc
nbg -> pjx
nbh -> hdv
nbi -> gdi
nbj -> jom
nbk -> jqu
nbl -> nui
nbm -> lre
nbn -> mad
nbo -> fde
nbp -> zos
nbq -> onp
nbr -> xmi
nbs -> tvs
nbt -> wil
nbu -> nkk
nbv -> oix
nbw -> djx
nbx -> igk
nby -> qeu
nbz -> fzp
nca -> hph
ncb -> xxv
ncc -> rjr
ncd -> itq
nce -> rhs
ncf -> whd
ncg -> mtc
nch -> whi
nci -> rvt
ncj -> cwa
nck -> kyt
ncl -> tkf
ncm -> ncu
ncn -> kuk
nco -> ogr
ncp -> sqt
ncq -> pny
ncr -> uyl
ncs -> snc
nct -> vht
ncu -> fis
ncv -> fwa
ncw -> qju
ncx -> wtq
ncy -> hht
ncz -> zvp
nda -> isx
ndb -> ozj
ndc -> kia
ndd -> xrw
nde -> bwv
ndf -> spx
ndg -> zwz
ndh -> vjy
ndi -> dsd
ndj -> dau
ndk -> bnj
ndl -> rfw
ndm -> dri
ndn -> ets
ndo -> ifc
ndp -> qhb
ndq -> tzs
ndr -> sri
nds -> uvl
ndt -> cit
ndu -> usg
ndv -> zui
ndw -> tjt
ndx -> fla
ndy -> piv
ndz -> hly
nea -> byb
neb -> nmx
nec -> ann
ned -> aph
nee -> lzl
nef -> gfd
neg -> rfu
neh -> wtx
nei -> oww
nej -> deu
nek -> mtv
nel -> ffh
nem -> ttw
nen -> xcf
neo -> fvv
nep -> vza
neq -> jha
ner -> qet
nes -> cdu
net -> ygr
neu -> jbf
nev -> bnn
new -> drv
nex -> sta
ney -> pnd
nez -> gar
nfa -> qlb
nfb -> qlt
nfc -> dle
nfd -> gui
nfe -> uvz
nff -> ynt
nfg -> xcq
nfh -> bjs
nfi -> cqn
nfj -> krx
nfk -> fwu
nfl -> snu
nfm -> dgu
nfn -> cel
nfo -> uik
nfp -> hbs
nfq -> zix
nfr -> rol
nfs -> lax
nft -> jkj
nfu -> ptw
nfv -> enl
nfw -> wdt
nfx -> nhl
nfy -> gfg
nfz -> tlg
nga -> inj
ngb -> rva
ngc -> rqj
ngd -> rvw
nge -> zdg
ngf -> vgu
ngg -> cez
ngh -> gpl
ngi -> ioa
ngj -> tma
ngk -> txa
ngl -> jpw
ngm -> ggf
ngn -> rqb
ngo -> tni
ngp -> jnb
ngq -> afs
ngr -> ljt
ngs -> npt
ngt -> uza
ngu -> klr
ngv -> hnm
ngw -> bmw
ngx -> wmf
ngy -> mur
ngz -> ehs
nha -> mpk
nhb -> xpf
nhc -> gvj
nhd -> vmc
nhe -> gww
nhf -> yai
nhg -> zcx
nhh -> ciy
nhi -> ciw
nhj -> vyb
nhk -> wbf
nhl -> zse
nhm -> chl
nhn -> lak
nho -> goh
nhp -> vqo
nhq -> lxj
nhr -> nwt
nhs -> gjy
nht -> pjc
nhu -> ika
nhv -> edm
nhw -> qrk
nhx -> xrf
nhy -> hwd
nhz -> fbd
nia -> eqy
nib -> mei
nic -> pur
nid -> fzd
nie -> cjc
nif -> nss
nig -> jgj
nih -> jdr
nii -> lat
nij -> kbe
nik -> knv
nil -> wwt
nim -> rwz
nin -> gnz
nio -> wwg
nip -> yvc
niq -> whk
nir -> pgl
nis -> eev
nit -> ruh
niu -> dvm
niv -> eew
niw -> clr
nix -> ups
niy -> fjd
niz -> gbc
nja -> gxb
njb -> lmp
njc -> gna
njd -> ulf
nje -> flj
njf -> fbt
njg -> baw
njh -> qiw
nji -> rhm
njj -> ezu
njk -> xmr
njl -> tvb
njm -> gxa
njn -> cqe
njo -> zxi
njp -> irk
njq -> sst
njr -> wix
njs -> ssj
njt -> eai
nju -> xzr
njv -> vfj
njw -> upp
njx -> ufm
njy -> rar
njz -> xqu
nka -> vxc
nkb -> ykx
nkc -> wde
nkd -> zvz
nke -> tas
nkf -> hfj
nkg -> vpo
nkh -> gya
nki -> zfe
nkj -> bil
nkk -> nmc
nkl -> ems
nkm -> yez
nkn -> ctv
nko -> myq
nkp -> rai
nkq -> umh
nkr -> enx
nks -> ucu
nkt -> yjo
nku -> lwn
nkv -> hpc
nkw -> ntb
nkx -> ndu
nky -> ogu
nkz -> kgt
nla -> tpc
nlb -> cvg
nlc -> vdc
nld -> ogn
nle -> qai
nlf -> erg
nlg -> kdt
nlh -> ixm
nli -> prp
nlj -> etn
nlk -> biq
nll -> foj
nlm -> alp
nln -> hwx
nlo -> orh
nlp -> hqe
nlq -> tzx
nlr -> jnt
nls -> vaj
nlt -> nsl
nlu -> kzb
nlv -> ejq
nlw -> qdt
nlx -> jsr
nly -> uep
nlz -> irr
nma -> kvm
nmb -> tci
nmc -> nvg
nmd -> pho
nme -> rjg
nmf -> nxt
nmg -> gkk
nmh -> umq
nmi -> tzg
nmj -> mzs
nmk -> nqr
nml -> krp
nmm -> qhn
nmn -> wfz
nmo -> emz
nmp -> asf
nmq -> dna
nmr -> svf
nms -> joc
nmt -> pnm
nmu -> yzl
nmv -> jtz
nmw -> arp
nmx -> lgc
nmy -> iwr
nmz -> unk
nna -> bcg
nnb -> swa
nnc -> twi
nnd -> lic
nne -> kwn
nnf -> obg
nng -> lrd
nnh -> gle
nni -> sct
nnj -> rro
nnk -> dcb
nnl -> wsr
nnm -> vgl
nnn -> fuq
nno -> rkb
nnp -> keh
nnq -> kuq
nnr -> hhz
nns -> ymr
nnt -> ziu
nnu -> ihz
nnv -> zsc
nnw -> ebb
nnx -> nka
nny -> qqv
nnz -> odw
noa -> gem
nob -> jvc
noc -> rzo
nod -> iej
noe -> epi
nof -> qee
nog -> cje
noh -> ziy
noi -> hkl
noj -> hsz
nok -> ojs
nol -> atb
nom -> tgp
non -> jwk
noo -> vma
nop -> zas
noq -> mif
nor -> aej
nos -> ckp
not -> cbq
nou -> wup
nov -> liq
now -> qyd
nox -> pcg
noy -> wll
noz -> iue
npa -> aya
npb -> gnv
npc -> ewd
npd -> aeg
npe -> phh
npf -> zwp
npg -> dqy
nph -> iru
npi -> fhg
npj -> tjc
npk -> uje
npl -> ldt
npm -> jdh
npn -> uiu
npo -> rpk
npp -> qij
npq -> qjd
npr -> akr
nps -> gvv
npt -> vak
npu -> qbl
npv -> cbd
npw -> gfy
npx -> och
npy -> gqe
npz -> efr
nqa -> wza
nqb -> gau
nqc -> sry
nqd -> gke
nqe -> qoh
nqf -> ivy
nqg -> xpa
nqh -> lpt
nqi -> ise
nqj -> hxn
nqk -> ufa
nql -> yrl
nqm -> vbi
nqn -> ryr
nqo -> qcf
nqp -> gub
nqq -> lio
nqr -> rzt
nqs -> qka
nqt -> zgw
nqu -> qnn
nqv -> cal
nqw -> qkg
nqx -> pdb
nqy -> tay
nqz -> yfm
nra -> ctd
nrb -> sfs
nrc -> dmu
nrd -> gfr
nre -> sxx
nrf -> idt
nrg -> ihv
nrh -> jar
nri -> csd
nrj -> koy
nrk -> rii
nrl -> ybh
nrm -> jlk
nrn -> isg
nro -> kpj
nrp -> ary
nrq -> wpt
nrr -> jki
nrs -> aro
nrt -> ysb
nru -> imk
nrv -> eyr
nrw -> edo
nrx -> igs
nry -> nan
nrz -> abj
nsa -> wlh
nsb -> oso
nsc -> ios
nsd -> lwr
nse -> zxm
nsf -> fyc
nsg -> mqk
nsh -> fcx
nsi -> ssv
nsj -> svu
nsk -> lmg
nsl -> efm
nsm -> sgt
nsn -> fpq
nso -> xtu
nsp -> vpc
nsq -> jht
nsr -> gwd
nss -> wnx
nst -> ofl
nsu -> gba
nsv -> qqf
nsw -> jse
nsx -> uup
nsy -> ktm
nsz -> omy
nta -> jlq
ntb -> fcl
ntc -> eop
ntd -> vxp
nte -> vxn
ntf -> uek
ntg -> hhl
nth -> dfx
nti -> zmh
ntj -> crk
ntk -> mcw
ntl -> rrj
ntm -> qmy
ntn -> gpk
nto -> ief
ntp -> ssf
ntq -> vbu
ntr -> jub
nts -> hyx
ntt -> cqr
ntu -> tcm
ntv -> ihw
ntw -> gxq
ntx -> xhx
nty -> ots
ntz -> mqb
nua -> yrz
nub -> qzz
nuc -> car
nud -> oxv
nue -> epe
nuf -> yne
nug -> sky
nuh -> oci
nui -> lnp
nuj -> jir
nuk -> vhf
nul -> vjz
num -> guc
nun -> rgj
nuo -> mai
nup -> ktw
nuq -> wgy
nur -> osc
nus -> juk
nut -> bvi
nuu -> roy
nuv -> bsd
nuw -> ybp
nux -> swd
nuy -> izb
nuz -> ecv
nva -> kpz
nvb -> fjx
nvc -> ypv
nvd -> cdw
nve -> jgn
nvf -> ekj
nvg -> kkr
nvh -> nty
nvi -> pzr
nvj -> eso
nvk -> zsb
nvl -> qsz
nvm -> nya
nvn -> xvq
nvo -> udg
nvp -> nff
nvq -> ptm
nvr -> zls
nvs -> gsz
nvt -> atg
nvu -> xyl
nvv -> iak
nvw -> nah
nvx -> ltx
nvy -> tgy
nvz -> fnv
nwa -> tuv
nwb -> wmn
nwc -> cos
nwd -> ply
nwe -> rnw
nwf -> yba
nwg -> jde
nwh -> imv
nwi -> hlk
nwj -> jkp
nwk -> fcv
nwl -> vlc
nwm -> bec
nwn -> eis
nwo -> vkm
nwp -> jxj
nwq -> doi
nwr -> vwx
nws -> ruj
nwt -> vlq
nwu -> bqu
nwv -> fun
nww -> zwq
nwx -> pau
nwy -> bnq
nwz -> iir
nxa -> ibs
nxb -> emo
nxc -> nkl
nxd -> qwj
nxe -> hij
nxf -> tpw
nxg -> mww
nxh -> nut
nxi -> woi
nxj -> fux
nxk -> gzt
nxl -> xjj
nxm -> ghf
nxn -> wcp
nxo -> xwf
nxp -> scl
nxq -> sns
nxr -> kbd
nxs -> wpd
nxt -> iti
nxu -> yfn
nxv -> sos
nxw -> pic
nxx -> gjc
nxy -> vhs
nxz -> nab
nya -> vzn
nyb -> skm
nyc -> qal
nyd -> ucp
nye -> kqh
nyf -> uwg
nyg -> tig
nyh -> swe
nyi -> tgt
nyj -> ita
nyk -> rpe
nyl -> wgw
nym -> zoj
nyn -> efx
nyo -> xha
nyp -> nej
nyq -> ihh
nyr -> cjb
nys -> cqh
nyt -> buo
nyu -> lcc
nyv -> ayd
nyw -> pig
nyx -> dhh
nyy -> bgz
nyz -> swh
nza -> xvt
nzb -> rij
nzc -> tar
nzd -> nlg
nze -> gxw
nzf -> fju
nzg -> ysh
nzh -> eup
nzi -> ctg
nzj -> usm
nzk -> oxs
nzl -> umf
nzm -> kgo
nzn -> tov
nzo -> owz
nzp -> wzf
nzq -> cxc
nzr -> mvo
nzs -> oyj
nzt -> xgt
nzu -> sae
nzv -> akb
nzw -> mer
nzx -> xln
nzy -> jkw
nzz -> guu
oaa -> mhs
oab -> chi
oac -> kjy
oad -> pxs
oae -> miq
oaf -> iys
oag -> rwb
oah -> mbn
oai -> lwo
oaj -> qlv
oak -> zia
oal -> hdl
oam -> nqf
oan -> nee
oao -> lma
oap -> qzp
oaq -> vvr
oar -> hyr
oas -> xwy
oat -> cqs
oau -> wur
oav -> ozi
oaw -> uug
oax -> yiv
oay -> img
oaz -> gdf
oba -> emh
obb -> krk
obc -> axv
obd -> vfm
obe -> fxc
obf -> foz
obg -> glc
obh -> gga
obi -> cid
obj -> fqc
obk -> klf
obl -> bkn
obm -> btt
obn -> zjm
obo -> kkg
obp -> kma
obq -> vpj
obr -> sdk
obs -> myr
obt -> jcg
obu -> hgq
obv -> hft
obw -> vtb
obx -> jsp
oby -> uxk
obz -> kjg
oca -> iki
ocb -> pkg
occ -> axc
ocd -> oic
oce -> sdx
ocf -> dyi
ocg -> wjg
och -> dyk
oci -> ksr
ocj -> mkb
ock -> ene
ocl -> epw
ocm -> qzu
ocn -> wkx
oco -> pmy
ocp -> wfm
ocq -> lnd
ocr -> kyg
ocs -> kbx
oct -> hfb
ocu -> vda
ocv -> ece
ocw -> upa
ocx -> zuc
ocy -> xbu
ocz -> nmp
oda -> tgz
odb -> cfr
odc -> ynn
odd -> bcu
ode -> wnw
odf -> voz
odg -> fpc
odh -> zqo
odi -> xqv
odj -> tug
odk -> iji
odl -> xdj
odm -> tdx
odn -> cxk
odo -> atk
odp -> vhl
odq -> uwz
odr -> mqu
ods -> vek
odt -> azi
odu -> icp
odv -> sed
odw -> xvf
odx -> fli
ody -> hpb
odz -> ehv
oea -> lcn
oeb -> ovt
oec -> txr
oed -> kaa
oee -> dke
oef -> pxc
oeg -> pbi
oeh -> wlb
oei -> dnf
oej -> iei
oek -> auo
oel -> nsi
oem -> oxd
oen -> ltz
oeo -> qnz
oep -> dxc
oeq -> qqr
oer -> wrb
oes -> zgx
oet -> jcs
oeu -> ixl
oev -> yqm
oew -> adh
oex -> dks
oey -> mto
oez -> mrv
ofa -> qte
ofb -> qxd
ofc -> ppn
ofd -> tof
ofe -> qno
off -> jhi
ofg -> oua
ofh -> wbz
ofi -> kzt
ofj -> ljv
ofk -> rpq
ofl -> tys
ofm -> sdm
ofn -> gps
ofo -> lil
ofp -> pfe
ofq -> xxy
ofr -> vqm
ofs -> zkw
oft -> bos
ofu -> ffe
ofv -> dpv
ofw -> nmy
ofx -> lqs
ofy -> jpm
ofz -> qzx
oga -> wzb
ogb -> xny
ogc -> tod
ogd -> ahj
oge -> hig
ogf -> fbk
ogg -> txh
ogh -> hio
ogi -> rjc
ogj -> wlg
ogk -> dtn
ogl -> gom
ogm -> hcd
ogn -> fuj
ogo -> gew
ogp -> ntr
ogq -> jrk
ogr -> sej
ogs -> pjv
ogt -> xry
ogu -> jte
ogv -> gwe
ogw -> syf
ogx -> feh
ogy -> xua
ogz -> hqf
oha -> wnj
ohb -> zgr
ohc -> kba
ohd -> hnc
ohe -> yer
ohf -> yel
ohg -> nar
ohh -> gyb
ohi -> btd
ohj -> hin
ohk -> lje
ohl -> reb
ohm -> vlg
ohn -> iyx
oho -> wxl
ohp -> prk
ohq -> ely
ohr -> klx
ohs -> dcx
oht -> vea
ohu -> lkn
ohv -> tpe
ohw -> duq
ohx -> bgw
ohy -> uyn
ohz -> vjn
oia -> mba
oib -> kka
oic -> isr
oid -> pul
oie -> kiq
oif -> ldx
oig -> his
oih -> izs
oii -> xvs
oij -> fud
oik -> owy
oil -> ojr
oim -> jua
oin -> gzj
oio -> krn
oip -> lcg
oiq -> bxb
oir -> ncb
ois -> obu
oit -> kgi
oiu -> ogw
oiv -> vzg
oiw -> tjs
oix -> jun
oiy -> zji
oiz -> yoa
oja -> abf
ojb -> xyf
ojc -> udp
ojd -> lka
oje -> iqr
ojf -> thx
ojg -> pza
ojh -> tdh
oji -> yww
ojj -> qll
ojk -> lbd
ojl -> osp
ojm -> vpb
ojn -> gvp
ojo -> wmr
ojp -> egv
ojq -> gek
ojr -> xnm
ojs -> rih
ojt -> tmy
oju -> dtv
ojv -> uiv
ojw -> run
ojx -> gvm
ojy -> xwh
ojz -> rms
oka -> dyd
okb -> yei
okc -> jef
okd -> wvt
oke -> sif
okf -> qli
okg -> tuj
okh -> oos
oki -> rxb
okj -> rbx
okk -> any
okl -> rzf
okm -> wkw
okn -> lnn
oko -> gni
okp -> quw
okq -> trn
okr -> qmg
oks -> jac
okt -> cdq
oku -> whq
okv -> ibz
okw -> vzk
okx -> kip
oky -> fii
okz -> xnu
ola -> evg
olb -> xwn
olc -> fck
old -> znf
ole -> ekd
olf -> qxu
olg -> jqd
olh -> uxs
oli -> vup
olj -> yzo
olk -> jip
oll -> jgx
olm -> ctx
oln -> thf
olo -> pxn
olp -> fkk
olq -> axd
olr -> maw
ols -> jra
olt -> tpx
olu -> rqv
olv -> pgd
olw -> iky
olx -> pun
oly -> llw
olz -> wvb
oma -> jcw
omb -> fji
omc -> xip
omd -> sjr
ome -> vxu
omf -> fxb
omg -> owh
omh -> fdn
omi -> hhk
omj -> xla
omk -> sbj
oml -> bxi
omm -> jod
omn -> exx
omo -> jbw
omp -> yqp
omq -> iec
omr -> hdq
oms -> ulo
omt -> ozy
omu -> lmm
omv -> olm
omw -> lbn
omx -> lqe
omy -> vhj
omz -> ghj
ona -> hgp
onb -> rid
onc -> cby
ond -> klo
one -> gmi
onf -> tyg
ong -> jsl
onh -> ctj
oni -> pvu
onj -> vkj
onk -> ojk
onl -> qng
onm -> elu
onn -> emp
ono -> izg
onp -> sip
onq -> zke
onr -> ldy
ons -> cph
ont -> uba
onu -> oqf
onv -> zyn
onw -> khk
onx -> rkl
ony -> ard
onz -> neg
ooa -> qzv
oob -> bad
ooc -> xxd
ood -> mhz
ooe -> nmn
oof -> iul
oog -> lgk
ooh -> tij
ooi -> vgg
ooj -> qqw
ook -> vzp
ool -> naa
oom -> jqh
oon -> jpt
ooo -> bws
oop -> xuy
ooq -> zti
oor -> omp
oos -> cil
oot -> bpw
oou -> wfy
oov -> ktr
oow -> rtt
oox -> uad
ooy -> raj
ooz -> zsd
opa -> lrg
opb -> aux
opc -> bcs
opd -> bwc
ope -> fov
opf -> tzp
opg -> abd
oph -> scv
opi -> hyc
opj -> bzh
opk -> jvi
opl -> iwl
opm -> pgx
opn -> rzz
opo -> kwq
opp -> xra
opq -> hiu
opr -> nir
ops -> mfj
opt -> dtd
opu -> clw
opv -> zhs
opw -> ous
opx -> sxc
opy -> nic
opz -> ewu
oqa -> mrj
oqb -> zhr
oqc -> bqw
oqd -> yfl
oqe -> onv
oqf -> itf
oqg -> vbq
oqh -> qeg
oqi -> auc
oqj -> tnz
oqk -> exk
oql -> wld
oqm -> vxm
oqn -> ete
oqo -> laf
oqp -> bai
oqq -> spa
oqr -> eon
oqs -> ctn
oqt -> qjg
oqu -> dnu
oqv -> wmp
oqw -> psb
oqx -> rpo
oqy -> hnk
oqz -> bco
ora -> jts
orb -> npf
orc -> jpj
ord -> mpu
ore -> qrr
orf -> zfg
org -> npv
orh -> fqu
ori -> wru
orj -> cjt
ork -> lxx
orl -> wun
orm -> pyw
orn -> eow
oro -> gph
orp -> swx
orq -> vwn
orr -> giy
ors -> stx
ort -> gpw
oru -> nnu
orv -> ejo
orw -> jzg
orx -> odb
ory -> ioj
orz -> xkk
osa -> rtw
osb -> onx
osc -> yqf
osd -> icm
ose -> win
osf -> ylc
osg -> mmp
osh -> mdo
osi -> wdy
osj -> nfe
osk -> vbt
osl -> uid
osm -> bbk
osn -> pne
oso -> kvj
osp -> jso
osq -> hum
osr -> esk
oss -> mun
ost -> ihc
osu -> hbm
osv -> qxa
osw -> rxh
osx -> fce
osy -> cfz
osz -> bzb
ota -> nxb
otb -> fwp
otc -> gat
otd -> icx
ote -> kue
otf -> wex
otg -> fyv
oth -> xsj
oti -> lfw
otj -> vrj
otk -> xls
otl -> yvo
otm -> aqz
otn -> xof
oto -> act
otp -> plu
otq -> wgx
otr -> xtp
ots -> gov
ott -> zri
otu -> bdj
otv -> uhi
otw -> mvc
otx -> cup
oty -> nct
otz -> unc
oua -> kph
oub -> jmx
ouc -> fty
oud -> wrc
oue -> adi
ouf -> yyn
oug -> nrt
ouh -> hxg
oui -> uoz
ouj -> kvg
ouk -> lvx
oul -> gav
oum -> dsz
oun -> cpr
ouo -> ucx
oup -> pxo
ouq -> fgf
our -> akp
ous -> ant
out -> fxr
ouu -> pca
ouv -> ufb
ouw -> itv
oux -> fxg
ouy -> dud
ouz -> amx
ova -> dvu
ovb -> svx
ovc -> uub
ovd -> rhv
ove -> dsg
ovf -> ljb
ovg -> gmw
ovh -> pyp
ovi -> aiz
ovj -> wqd
ovk -> oyx
ovl -> xhp
ovm -> zzr
ovn -> zem
ovo -> dws
ovp -> agg
ovq -> yzv
ovr -> uso
ovs -> gji
ovt -> kly
ovu -> dey
ovv -> fea
ovw -> ifi
ovx -> vls
ovy -> iyp
ovz -> dhe
owa -> erp
owb -> wje
owc -> ebx
owd -> dib
owe -> vtx
owf -> bdd
owg -> ndd
owh -> bjg
owi -> pgh
owj -> sfz
owk -> etd
owl -> apm
owm -> tqt
own -> oka
owo -> bih
owp -> keo
owq -> sfm
owr -> rbi
ows -> xrr
owt -> qjv
owu -> rcs
owv -> yuo
oww -> rhh
owx -> nze
owy -> mdn
owz -> sla
oxa -> fki
oxb -> mtw
oxc -> nuw
oxd -> ypp
oxe -> djt
oxf -> xdc
oxg -> nzp
oxh -> noq
oxi -> bsy
oxj -> kun
oxk -> wyf
oxl -> hln
oxm -> cii
oxn -> jbq
oxo -> eba
oxp -> xfm
oxq -> mju
oxr -> hen
oxs -> gur
oxt -> bvn
oxu -> ais
oxv -> atp
oxw -> aml
oxx -> zzk
oxy -> fya
oxz -> ovm
oya -> acz
oyb -> iuu
oyc -> aus
oyd -> lrb
oye -> iie
oyf -> jxx
oyg -> bvy
oyh -> mnf
oyi -> ipk
oyj -> tnv
oyk -> vlz
oyl -> sbz
oym -> wqp
oyn -> vpv
oyo -> mgh
oyp -> qvt
oyq -> qpv
oyr -> oov
oys -> oep
oyt -> com
oyu -> dpl
oyv -> pbw
oyw -> kkn
oyx -> lmv
oyy -> fbr
oyz -> zjf
oza -> rss
ozb -> ikk
ozc -> sjl
ozd -> dvj
oze -> red
ozf -> mwx
ozg -> vmg
ozh -> int
ozi -> ire
ozj -> trj
ozk -> zey
ozl -> ohq
ozm -> lav
ozn -> avw
ozo -> efo
ozp -> zrw
ozq -> crs
ozr -> eyo
ozs -> bzm
ozt -> zoh
ozu -> aje
ozv -> lpx
ozw -> rnd
ozx -> sud
ozy -> gnn
ozz -> sfy
paa -> xxp
pab -> aeq
pac -> ewm
pad -> xhr
pae -> kqa
paf -> rzp
pag -> fqd
pah -> pbb
pai -> wep
paj -> ure
pak -> ypu
pal -> vxq
pam -> yiq
pan -> jpz
pao -> bbv
pap -> tvo
paq -> gqg
par -> vzx
pas -> fgh
pat -> wmo
pau -> cue
pav -> apf
paw -> qaz
pax -> qrn
pay -> ehc
paz -> rpi
pba -> swm
pbb -> xjl
pbc -> etc
pbd -> jov
pbe -> cmb
pbf -> xpx
pbg -> zmn
pbh -> gaw
pbi -> lho
pbj -> tzi
pbk -> vdv
pbl -> ahl
pbm -> lwi
pbn -> ktu
pbo -> mvf
pbp -> uwh
pbq -> bdv
pbr -> vln
pbs -> nkw
pbt -> ovo
pbu -> cdr
pbv -> ifs
pbw -> sti
pbx -> lyh
pby -> ovl
pbz -> nju
pca -> bom
pcb -> hxk
pcc -> olc
pcd -> qhg
pce -> uum
pcf -> acg
pcg -> xjh
pch -> vmw
pci -> ysy
pcj -> cif
pck -> yju
pcl -> fpx
pcm -> ehh
pcn -> ics
pco -> cgf
pcp -> wqg
pcq -> mxr
pcr -> dxm
pcs -> awn
pct -> mhb
pcu -> wmv
pcv -> osb
pcw -> cdz
pcx -> wyg
pcy -> gxn
pcz -> kxs
pda -> sqi
pdb -> apv
pdc -> qhs
pdd -> lxi
pde -> okq
pdf -> zus
pdg -> aga
pdh -> ueq
pdi -> zna
pdj -> rip
pdk -> goi
pdl -> ccc
pdm -> cfa
pdn -> vge
pdo -> dlu
pdp -> vel
pdq -> poz
pdr -> sng
pds -> rgc
pdt -> wzu
pdu -> ajw
pdv -> vkl
pdw -> rcx
pdx -> svn
pdy -> xjv
pdz -> had
pea -> qlu
peb -> hos
pec -> tuf
ped -> vzd
pee -> pzi
pef -> lkv
peg -> tiq
peh -> zdc
pei -> lcz
pej -> ldb
pek -> zpq
pel -> los
pem -> eti
pen -> dsu
peo -> lwp
pep -> piq
peq -> sgd
per -> weu
pes -> dyw
pet -> dbx
peu -> nfs
pev -> rgk
pew -> gzq
pex -> kll
pey -> rah
pez -> sbh
pfa -> ltd
pfb -> fgz
pfc -> avj
pfd -> duy
pfe -> ojz
pff -> ppi
pfg -> csg
pfh -> mco
pfi -> ori
pfj -> asw
pfk -> cfy
pfl -> ezd
pfm -> sas
pfn -> dwp
pfo -> wdl
pfp -> ksc
pfq -> yek
pfr -> hff
pfs -> ckb
pft -> lcw
pfu -> iis
pfv -> rsw
pfw -> mqd
pfx -> zkn
pfy -> veo
pfz -> ltw
pga -> ncx
pgb -> bss
pgc -> xdh
pgd -> tic
pge -> nyx
pgf -> tbs
pgg -> uzw
pgh -> ljg
pgi -> fqz
pgj -> pvg
pgk -> cac
pgl -> tjj
pgm -> rdf
pgn -> xdi
pgo -> jrj
pgp -> cwh
pgq -> bzp
pgr -> lxp
pgs -> zbk
pgt -> lcq
pgu -> euf
pgv -> bui
pgw -> wmk
pgx -> bpa
pgy -> jvj
pgz -> cht
pha -> wno
phb -> cdb
phc -> pcd
phd -> fcj
phe -> ksf
phf -> vlv
phg -> igg
phh -> dns
phi -> zjp
phj -> lrq
phk -> waf
phl -> ixf
phm -> ezv
phn -> uqm
pho -> jjq
php -> ogg
phq -> xde
phr -> kpp
phs -> fph
pht -> wxy
phu -> itb
phv -> cki
phw -> ybw
phx -> liz
phy -> rnq
phz -> qib
pia -> grw
pib -> rzn
pic -> hqz
pid -> etu
pie -> uzo
pif -> zqs
pig -> dss
pih -> mkz
pii -> ypx
pij -> fln
pik -> vjm
pil -> vtd
pim -> abc
pin -> vyd
pio -> tga
pip -> cky
piq -> ido
pir -> avi
pis -> bkh
pit -> mpg
piu -> jva
piv -> nzq
piw -> aod
pix -> wwp
piy -> abq
piz -> ctq
pja -> rhp
pjb -> aev
pjc -> yex
pjd -> dmq
pje -> rho
pjf -> zkz
pjg -> ksw
pjh -> hcz
pji -> ict
pjj -> smc
pjk -> nkp
pjl -> ojt
pjm -> dav
pjn -> gxi
pjo -> roa
pjp -> nxv
pjq -> xri
pjr -> mil
pjs -> bbp
pjt -> ego
pju -> fxx
pjv -> rsh
pjw -> slv
pjx -> aop
pjy -> zlk
pjz -> ivh
pka -> avs
pkb -> jqc
pkc -> ppp
pkd -> ujb
pke -> bhd
pkf -> jbl
pkg -> gex
pkh -> rhk
pki -> yjg
pkj -> wla
pkk -> djk
pkl -> afq
pkm -> epm
pkn -> ysf
pko -> fxn
pkp -> ruo
pkq -> upd
pkr -> dic
pks -> bhe
pkt -> ija
pku -> gcq
pkv -> yzt
pkw -> udv
pkx -> gne
pky -> bnf
pkz -> tiy
pla -> cdo
plb -> wqc
plc -> vph
pld -> dts
ple -> cad
plf -> ybv
plg -> sqz
plh -> jlz
pli -> pad
plj -> uqu
plk -> cqd
pll -> twp
plm -> sgv
pln -> jot
plo -> zug
plp -> mgg
plq -> czq
plr -> leg
pls -> ynp
plt -> iyg
plu -> col
plv -> gtx
plw -> zaz
plx -> yyq
ply -> ffl
plz -> bdl
pma -> pas
pmb -> ymc
pmc -> gbe
pmd -> yxp
pme -> jhr
pmf -> wev
pmg -> llv
pmh -> xiw
pmi -> lit
pmj -> vyz
pmk -> mdp
pml -> ebs
pmm -> ltg
pmn -> sda
pmo -> hoa
pmp -> ugv
pmq -> jpc
pmr -> oun
pms -> qvu
pmt -> xdr
pmu -> joz
pmv -> wug
pmw -> ngf
pmx -> vwj
pmy -> sid
pmz -> baz
pna -> kpy
pnb -> ipf
pnc -> edy
pnd -> qpq
pne -> mtz
pnf -> myw
png -> fhy
pnh -> bfn
pni -> vja
pnj -> ity
pnk -> wnt
pnl -> jas
pnm -> zvj
pnn -> bbm
pno -> xwb
pnp -> jkb
pnq -> vnk
pnr -> eqw
pns -> wcw
pnt -> qdr
pnu -> tby
pnv -> bmz
pnw -> dbn
pnx -> eob
pny -> umk
pnz -> xnq
poa -> jsv
pob -> rmu
poc -> ath
pod -> pif
poe -> njp
pof -> pia
pog -> ygo
poh -> pcq
poi -> xko
poj -> llq
pok -> lhd
pol -> ney
pom -> sfx
pon -> ail
poo -> jpa
pop -> xtq
poq -> zeu
por -> ykw
pos -> laa
pot -> bwq
pou -> vgp
pov -> nwn
pow -> hre
pox -> ppe
poy -> tdf
poz -> zzt
ppa -> qum
ppb -> cat
ppc -> hfs
ppd -> vks
ppe -> uop
ppf -> agp
ppg -> jmn
pph -> qvf
ppi -> ogy
ppj -> kxm
ppk -> iil
ppl -> wzc
ppm -> cuz
ppn -> bts
ppo -> hcs
ppp -> tzv
ppq -> lxt
ppr -> znx
pps -> xds
ppt -> oyf
ppu -> uvh
ppv -> txj
ppw -> cxd
ppx -> dpz
ppy -> apk
ppz -> szn
pqa -> nvv
pqb -> cij
pqc -> uwq
pqd -> yci
pqe -> ilw
pqf -> oaw
pqg -> pej
pqh -> frm
pqi -> bll
pqj -> new
pqk -> wtd
pql -> ghz
pqm -> zuw
pqn -> mre
pqo -> vzo
pqp -> qxj
pqq -> iyw
pqr -> cxz
pqs -> zgy
pqt -> tgq
pqu -> vix
pqv -> jop
pqw -> pyy
pqx -> zbe
pqy -> rzq
pqz -> wxh
pra -> ynj
prb -> chc
prc -> xzx
prd -> dyc
pre -> usu
prf -> nmv
prg -> jio
prh -> gyd
pri -> xje
prj -> ypi
prk -> lel
prl -> xam
prm -> chp
prn -> srn
pro -> pav
prp -> osu
prq -> uou
prr -> gms
prs -> jnx
prt -> xau
pru -> avc
prv -> pcv
prw -> ywf
prx -> oxe
pry -> caj
prz -> kok
psa -> pcn
psb -> zqm
psc -> hmz
psd -> lwg
pse -> xug
psf -> roc
psg -> vae
psh -> ujq
psi -> fkj
psj -> coq
psk -> qgi
psl -> gdw
psm -> eep
psn -> tra
pso -> gpa
psp -> sss
psq -> thn
psr -> ejy
pss -> swt
pst -> myf
psu -> nel
psv -> bro
psw -> eta
psx -> fic
psy -> eqh
psz -> sei
pta -> atv
ptb -> mdf
ptc -> fmi
ptd -> hnr
pte -> lkx
ptf -> yco
ptg -> vsq
pth -> sic
pti -> hxw
ptj -> njt
ptk -> eoi
ptl -> mwp
ptm -> vqt
ptn -> dya
pto -> rnp
ptp -> saj
ptq -> jnp
ptr -> rdg
pts -> txs
ptt -> pda
ptu -> ewn
ptv -> grj
ptw -> ban
ptx -> iui
pty -> wxw
ptz -> qov
pua -> wln
pub -> xwe
puc -> yow
pud -> pyr
pue -> qvk
puf -> wxn
pug -> aol
puh -> qzb
pui -> wsd
puj -> rox
puk -> kgj
pul -> rum
pum -> wua
pun -> tge
puo -> tnd
pup -> hzm
puq -> cth
pur -> xqt
pus -> qxf
put -> hko
puu -> drh
puv -> fmg
puw -> vsd
pux -> dqr
puy -> fpd
puz -> raz
pva -> kvz
pvb -> uvc
pvc -> wps
pvd -> uru
pve -> wac
pvf -> cru
pvg -> skg
pvh -> pbv
pvi -> gtk
pvj -> xwg
pvk -> adm
pvl -> equ
pvm -> aiw
pvn -> mql
pvo -> zea
pvp -> htt
pvq -> prb
pvr -> hik
pvs -> ign
pvt -> rkj
pvu -> cuj
pvv -> nuo
pvw -> slb
pvx -> fik
pvy -> uxr
pvz -> opc
pwa -> fcu
pwb -> omm
pwc -> lro
pwd -> eqf
pwe -> ify
pwf -> wyi
pwg -> vgi
pwh -> bua
pwi -> zef
pwj -> bzw
pwk -> yjw
pwl -> aiq
pwm -> vlf
pwn -> jfx
pwo -> ifd
pwp -> zkx
pwq -> fmc
pwr -> iuq
pws -> czc
pwt -> rqy
pwu -> nuq
pwv -> tyl
pww -> eou
pwx -> ksv
pwy -> icv
pwz -> qxi
pxa -> wbk
pxb -> dzp
pxc -> rku
pxd -> oyk
pxe -> mjb
pxf -> kgl
pxg -> qom
pxh -> gvs
pxi -> det
pxj -> qmh
pxk -> hsu
pxl -> taq
pxm -> iiv
pxn -> mij
pxo -> eae
pxp -> uxq
pxq -> qvh
pxr -> zab
pxs -> zmt
pxt -> xlr
pxu -> nec
pxv -> wrs
pxw -> amd
pxx -> gnx
pxy -> wgj
pxz -> yld
pya -> muz
pyb -> kcn
pyc -> qge
pyd -> fpm
pye -> hsa
pyf -> tlm
pyg -> fxq
pyh -> eeq
pyi -> lip
pyj -> qxm
pyk -> hwk
pyl -> wcr
pym -> aib
pyn -> yua
pyo -> mae
pyp -> wpa
pyq -> iub
pyr -> hkb
pys -> rhw
pyt -> hek
pyu -> lih
pyv -> nhc
pyw -> uyw
pyx -> ghr
pyy -> ytt
pyz -> opb
pza -> cee
pzb -> xon
pzc -> lzo
pzd -> utr
pze -> eeb
pzf -> isb
pzg -> hyb
pzh -> nen
pzi -> xco
pzj -> kms
pzk -> uuc
pzl -> cvh
pzm -> efn
pzn -> iiw
pzo -> irx
pzp -> ray
pzq -> jep
pzr -> gtb
pzs -> aim
pzt -> otn
pzu -> jqn
pzv -> jlm
pzw -> avg
pzx -> wdx
pzy -> gkn
pzz -> bkg
qaa -> ewb
qab -> qbk
qac -> ioq
qad -> bbq
qae -> plb
qaf -> jpd
qag -> uix
qah -> mie
qai -> hhg
qaj -> bon
qak -> ucy
qal -> vjq
qam -> mxg
qan -> dvv
qao -> tej
qap -> qph
qaq -> sat
qar -> csb
qas -> fah
qat -> jud
qau -> ean
qav -> ppq
qaw -> yvs
qax -> ivk
qay -> kmz
qaz -> llt
qba -> yri
qbb -> lhi
qbc -> bxf
qbd -> rgz
qbe -> bvb
qbf -> ech
qbg -> skr
qbh -> biz
qbi -> oat
qbj -> ljk
qbk -> wlp
qbl -> vvb
qbm -> nxh
qbn -> epc
qbo -> gcd
qbp -> dtq
qbq -> wtk
qbr -> gpe
qbs -> hhq
qbt -> ccs
qbu -> ynf
qbv -> pft
qbw -> voh
qbx -> cjh
qby -> xqf
qbz -> huz
qca -> mfo
qcb -> uql
qcc -> fyy
qcd -> wdo
qce -> glv
qcf -> gjz
qcg -> qlh
qch -> aqp
qci -> ema
qcj -> ryh
qck -> ecn
qcl -> xkm
qcm -> cjs
qcn -> xcl
qco -> sbt
qcp -> gzb
qcq -> wbj
qcr -> vrh
qcs -> lpr
qct -> wnm
qcu -> tdj
qcv -> dzz
qcw -> bcc
qcx -> ono
qcy -> qey
qcz -> snf
qda -> llr
qdb -> uwd
qdc -> sjg
qdd -> rek
qde -> hqb
qdf -> qnh
qdg -> dnt
qdh -> swo
qdi -> nwr
qdj -> jox
qdk -> eoe
qdl -> cbt
qdm -> maz
qdn -> kbs
qdo -> cwn
qdp -> bta
qdq -> mpw
qdr -> ehi
qds -> hib
qdt -> hzq
qdu -> xsz
qdv -> zth
qdw -> tzc
qdx -> jwv
qdy -> fip
qdz -> xoi
qea -> xjb
qeb -> yep
qec -> atj
qed -> yhg
qee -> aww
qef -> bba
qeg -> vlu
qeh -> vsb
qei -> snb
qej -> atf
qek -> djb
qel -> tbo
qem -> qiz
qen -> qyn
qeo -> fcf
qep -> drs
qeq -> pzk
qer -> hnx
qes -> srw
qet -> quh
qeu -> fmt
qev -> fsh
qew -> dyo
qex -> xdn
qey -> ruy
qez -> mqt
qfa -> mfx
qfb -> bge
qfc -> byp
qfd -> izi
qfe -> jfv
qff -> xsk
qfg -> ajr
qfh -> qqu
qfi -> dxv
qfj -> pqz
qfk -> yuj
qfl -> dze
qfm -> bof
qfn -> nks
qfo -> fwl
qfp -> mqo
qfq -> kft
qfr -> lnb
qfs -> pyu
qft -> hhd
qfu -> ooo
qfv -> web
qfw -> bmu
qfx -> oak
qfy -> wys
qfz -> lxn
qga -> gpd
qgb -> eos
qgc -> inx
qgd -> rkp
qge -> zwc
qgf -> vuy
qgg -> lfi
qgh -> bgy
qgi -> skp
qgj -> hjh
qgk -> crh
qgl -> rmz
qgm -> ghx
qgn -> rtx
qgo -> rft
qgp -> kxf
qgq -> fxp
qgr -> uqw
qgs -> gxm
qgt -> wwn
qgu -> cgs
qgv -> fxk
qgw -> lvr
qgx -> spm
qgy -> qxb
qgz -> dzm
qha -> ubo
qhb -> bye
qhc -> yle
qhd -> mlr
qhe -> roh
qhf -> gwl
qhg -> nkc
qhh -> ozs
qhi -> hqw
qhj -> rtl
qhk -> iim
qhl -> lvp
qhm -> gzn
qhn -> wee
qho -> hiq
qhp -> myn
qhq -> mnt
qhr -> nqe
qhs -> ons
qht -> jbx
qhu -> nbq
qhv -> wew
qhw -> kzx
qhx -> oqq
qhy -> odt
qhz -> umd
qia -> btj
qib -> acy
qic -> ybq
qid -> zrv
qie -> ith
qif -> lku
qig -> xfc
qih -> jeu
qii -> ggy
qij -> esb
qik -> naz
qil -> ocx
qim -> rgt
qin -> zxk
qio -> ouf
qip -> pud
qiq -> cbl
qir -> xgx
qis -> ueh
qit -> gyw
qiu -> pkq
qiv -> gzk
qiw -> yzn
qix -> hll
qiy -> old
qiz -> djo
qja -> nku
qjb -> kpc
qjc -> kgm
qjd -> mdk
qje -> bhn
qjf -> zso
qjg -> oyh
qjh -> npi
qji -> miz
qjj -> jbe
qjk -> xly
qjl -> syg
qjm -> boi
qjn -> gbp
qjo -> ume
qjp -> hmn
qjq -> njh
qjr -> xov
qjs -> dcd
qjt -> ags
qju -> wwi
qjv -> qfi
qjw -> syu
qjx -> npl
qjy -> has
qjz -> unf
qka -> mlo
qkb -> cei
qkc -> vcb
qkd -> wbw
qke -> sgm
qkf -> lgt
qkg -> qbj
qkh -> fml
qki -> vgs
qkj -> edt
qkk -> yhl
qkl -> dom
qkm -> ztg
qkn -> aqi
qko -> qne
qkp -> qbn
qkq -> hgz
qkr -> kqo
qks -> bby
qkt -> ale
qku -> bnz
qkv -> yhi
qkw -> vvo
qkx -> jxl
qky -> ujp
qkz -> lpp
qla -> kwl
qlb -> vxr
qlc -> toa
qld -> afk
qle -> vvn
qlf -> eav
qlg -> nvu
qlh -> pjk
qli -> twx
qlj -> xwd
qlk -> lab
qll -> fey
qlm -> vzf
qln -> xrj
qlo -> qfb
qlp -> aaw
qlq -> yzw
qlr -> vrs
qls -> moi
qlt -> pui
qlu -> njw
qlv -> dvg
qlw -> kpt
qlx -> vgy
qly -> mjh
qlz -> hym
qma -> gra
qmb -> gyt
qmc -> yqh
qmd -> rbj
qme -> kfp
qmf -> jlr
qmg -> ahy
qmh -> cxg
qmi -> aki
qmj -> xmq
qmk -> snl
qml -> vij
qmm -> mtp
qmn -> pzn
qmo -> ree
qmp -> dwe
qmq -> tyq
qmr -> uma
qms -> ooz
qmt -> mtu
qmu -> iyu
qmv -> gan
qmw -> gmp
qmx -> yoe
qmy -> tgn
qmz -> olu
qna -> kae
qnb -> kky
qnc -> xsf
qnd -> zqf
qne -> tku
qnf -> vbe
qng -> kot
qnh -> gfp
qni -> iwf
qnj -> lut
qnk -> rke
qnl -> hjn
qnm -> lzp
qnn -> vfx
qno -> xyz
qnp -> kji
qnq -> gsp
qnr -> mky
qns -> ked
qnt -> zgg
qnu -> xrv
qnv -> rst
qnw -> wdd
qnx -> ctf
qny -> bje
qnz -> uwu
qoa -> utw
qob -> ryx
qoc -> nzd
qod -> bik
qoe -> pxa
qof -> pec
qog -> mdh
qoh -> wdq
qoi -> ozl
qoj -> tpb
qok -> poo
qol -> nld
qom -> qpn
qon -> zhj
qoo -> ljp
qop -> hbl
qoq -> zub
qor -> ujc
qos -> crm
qot -> xcu
qou -> phe
qov -> jyd
qow -> aoj
qox -> onl
qoy -> gku
qoz -> ryq
qpa -> xfq
qpb -> bpd
qpc -> lbc
qpd -> zyo
qpe -> jzv
qpf -> dpm
qpg -> ohx
qph -> qce
qpi -> mvk
qpj -> uxo
qpk -> oiy
qpl -> drz
qpm -> shm
qpn -> tsn
qpo -> noj
qpp -> sig
qpq -> bbx
qpr -> zpn
qps -> cci
qpt -> vdq
qpu -> omg
qpv -> ymi
qpw -> ikp
qpx -> oyd
qpy -> qyz
qpz -> tdt
qqa -> ell
qqb -> phd
qqc -> iwh
qqd -> epo
qqe -> xfo
qqf -> fyp
qqg -> jqs
qqh -> mnu
qqi -> dln
qqj -> jat
qqk -> fop
qql -> ysd
qqm -> qpb
qqn -> odm
qqo -> bup
qqp -> yja
qqq -> xwk
qqr -> sgy
qqs -> bgm
qqt -> tbh
qqu -> epj
qqv -> ttg
qqw -> nlw
qqx -> bzj
qqy -> wah
qqz -> uue
qra -> khl
qrb -> mom
qrc -> mpq
qrd -> uhu
qre -> dho
qrf -> eju
qrg -> goq
qrh -> dpo
qri -> dfh
qrj -> hhi
qrk -> lgz
qrl -> zrh
qrm -> fng
qrn -> bmm
qro -> qaj
qrp -> rhu
qrq -> eus
qrr -> gno
qrs -> qtq
qrt -> mgw
qru -> fyq
qrv -> hgn
qrw -> hkd
qrx -> qbt
qry -> gtz
qrz -> loo
qsa -> mcc
qsb -> klk
qsc -> hfa
qsd -> odn
qse -> ljc
qsf -> jjg
qsg -> nrn
qsh -> yik
qsi -> aot
qsj -> oxm
qsk -> iqe
qsl -> qze
qsm -> fpj
qsn -> yyd
qso -> mar
qsp -> avb
qsq -> lmz
qsr -> kns
qss -> rnr
qst -> qpr
qsu -> bsh
qsv -> hao
qsw -> frw
qsx -> dlo
qsy -> otl
qsz -> kgk
qta -> fcg
qtb -> ela
qtc -> qic
qtd -> cxs
qte -> hcm
qtf -> fdr
qtg -> kbf
qth -> ytj
qti -> vlh
qtj -> fqg
qtk -> tor
qtl -> rjs
qtm -> seb
qtn -> zwx
qto -> skx
qtp -> den
qtq -> ejt
qtr -> sbm
qts -> wyx
qtt -> yat
qtu -> jjs
qtv -> kgb
qtw -> trq
qtx -> ivj
qty -> pon
qtz -> dfe
qua -> iaw
qub -> iur
quc -> qcr
qud -> eog
que -> bwl
quf -> rui
qug -> zjb
quh -> qbs
qui -> sjo
quj -> ndb
quk -> npm
qul -> knh
qum -> fvw
qun -> irj
quo -> nur
qup -> jpn
quq -> xaw
qur -> shq
qus -> ynl
qut -> ipg
quu -> jwo
quv -> ndl
quw -> bri
qux -> lyq
quy -> zwg
quz -> hsr
qva -> gng
qvb -> vtv
qvc -> gqh
qvd -> opv
qve -> nzi
qvf -> ira
qvg -> tdi
qvh -> saq
qvi -> rec
qvj -> uvt
qvk -> syn
qvl -> ufk
qvm -> hdp
qvn -> iaj
qvo -> rvq
qvp -> adr
qvq -> lcj
qvr -> uqx
qvs -> ukp
qvt -> ggu
qvu -> gcx
qvv -> saw
qvw -> bgl
qvx -> ijc
qvy -> kmg
qvz -> bkk
qwa -> knn
qwb -> fhf
qwc -> xmd
qwd -> tae
qwe -> hso
qwf -> vag
qwg -> mef
qwh -> jqr
qwi -> wvn
qwj -> vyn
qwk -> ugf
qwl -> kwd
qwm -> fqt
qwn -> htj
qwo -> kgn
qwp -> mfz
qwq -> yuh
qwr -> acm
qws -> vlw
qwt -> opo
qwu -> sam
qwv -> bff
qww -> epp
qwx -> jca
qwy -> ibn
qwz -> qwg
qxa -> fva
qxb -> qfy
qxc -> agv
qxd -> zgi
qxe -> yxz
qxf -> hvy
qxg -> mqi
qxh -> qej
qxi -> qdy
qxj -> syi
qxk -> kpw
qxl -> dvx
qxm -> vjb
qxn -> egw
qxo -> qqo
qxp -> miv
qxq -> jsb
qxr -> hoh
qxs -> urm
qxt -> yed
qxu -> ilg
qxv -> wow
qxw -> vit
qxx -> rqd
qxy -> prn
qxz -> euy
qya -> rfk
qyb -> smj
qyc -> cet
qyd -> bse
qye -> cry
qyf -> ovp
qyg -> oav
qyh -> fho
qyi -> vwc
qyj -> des
qyk -> ffr
qyl -> mqq
qym -> bbs
qyn -> wjy
qyo -> cvp
qyp -> off
qyq -> chu
qyr -> lsv
qys -> rxa
qyt -> sxa
qyu -> fkm
qyv -> qdp
qyw -> nkz
qyx -> rfl
qyy -> uov
qyz -> rcd
qza -> zzl
qzb -> yki
qzc -> lyt
qzd -> hoj
qze -> gyx
qzf -> tqf
qzg -> lki
qzh -> uxg
qzi -> ihl
qzj -> gpu
qzk -> nph
qzl -> vpr
qzm -> cwv
qzn -> mum
qzo -> swp
qzp -> dkl
qzq -> qek
qzr -> pbp
qzs -> uuz
qzt -> iee
qzu -> mzu
qzv -> giv
qzw -> xjt
qzx -> fgs
qzy -> rob
qzz -> oud
raa -> zlw
rab -> rov
rac -> pyj
rad -> idc
rae -> xcm
raf -> nhh
rag -> cxn
rah -> ult
rai -> vov
raj -> npo
rak -> pmk
ral -> jiw
ram -> aja
ran -> utd
rao -> ams
rap -> mhx
raq -> pzf
rar -> xka
ras -> rji
rat -> yvi
rau -> qyk
rav -> xps
raw -> zcf
rax -> rfs
ray -> pyx
raz -> hdg
rba -> nhw
rbb -> biy
rbc -> ris
rbd -> ozw
rbe -> rkq
rbf -> lbu
rbg -> gfk
rbh -> vwp
rbi -> yps
rbj -> hlw
rbk -> xob
rbl -> doz
rbm -> abe
rbn -> azf
rbo -> qqg
rbp -> tje
rbq -> xno
rbr -> vlp
rbs -> bpb
rbt -> mkn
rbu -> rgg
rbv -> qkq
rbw -> ezr
rbx -> hmb
rby -> kzf
rbz -> jzt
rca -> oja
rcb -> xsb
rcc -> kvf
rcd -> oxl
rce -> yxx
rcf -> got
rcg -> cxj
rch -> jpi
rci -> jaz
rcj -> qco
rck -> iwv
rcl -> hsp
rcm -> ang
rcn -> awp
rco -> fui
rcp -> pcm
rcq -> xjw
rcr -> cqq
rcs -> ptc
rct -> dru
rcu -> xiv
rcv -> txd
rcw -> ijs
rcx -> pzx
rcy -> xkc
rcz -> dvf
rda -> iuc
rdb -> xgh
rdc -> nfb
rdd -> iyo
rde -> mbw
rdf -> yar
rdg -> uns
rdh -> ozg
rdi -> lgh
rdj -> yfr
rdk -> ngu
rdl -> xoy
rdm -> rhb
rdn -> xfn
rdo -> dsh
rdp -> zry
rdq -> qhh
rdr -> tvp
rds -> pyb
rdt -> yao
rdu -> bug
rdv -> dvc
rdw -> hxx
rdx -> yfk
rdy -> qlk
rdz -> rni
rea -> ssu
reb -> mxp
rec -> eiy
red -> dur
ree -> nez
ref -> jcr
reg -> tvr
reh -> sgx
rei -> azn
rej -> vsv
rek -> xay
rel -> lgf
rem -> dcc
ren -> cmf
reo -> vux
rep -> wmw
req -> zqv
rer -> xrt
res -> drw
ret -> zio
reu -> lef
rev -> cjf
rew -> mfr
rex -> zfb
rey -> rge
rez -> aea
rfa -> qoc
rfb -> apo
rfc -> khm
rfd -> vbf
rfe -> wtz
rff -> jon
rfg -> yes
rfh -> voq
rfi -> uye
rfj -> cjr
rfk -> pbo
rfl -> nsk
rfm -> pow
rfn -> jgp
rfo -> czb
rfp -> ctk
rfq -> eaa
rfr -> njv
rfs -> qap
rft -> wbm
rfu -> dhn
rfv -> czs
rfw -> gln
rfx -> ltn
rfy -> wlk
rfz -> hov
rga -> xkb
rgb -> euc
rgc -> rnk
rgd -> kda
rge -> akw
rgf -> gtj
rgg -> wbh
rgh -> jga
rgi -> eda
rgj -> uqh
rgk -> kwy
rgl -> sxv
rgm -> igh
rgn -> eug
rgo -> yti
rgp -> pmi
rgq -> rrq
rgr -> inv
rgs -> ojd
rgt -> hzr
rgu -> pco
rgv -> vbp
rgw -> ora
rgx -> niz
rgy -> vqv
rgz -> fxo
rha -> tym
rhb -> yhs
rhc -> jku
rhd -> evi
rhe -> jld
rhf -> hpx
rhg -> rxn
rhh -> lwt
rhi -> uig
rhj -> xhe
rhk -> tjn
rhl -> axy
rhm -> pss
rhn -> enp
rho -> gkw
rhp -> fnc
rhq -> jrt
rhr -> yaa
rhs -> zra
rht -> qku
rhu -> fpu
rhv -> zsu
rhw -> sms
rhx -> whb
rhy -> rzc
rhz -> gvu
ria -> zyt
rib -> okb
ric -> xkh
rid -> uhf
rie -> fcy
rif -> swu
rig -> fct
rih -> lph
rii -> nos
rij -> aze
rik -> ava
ril -> bya
rim -> yrr
rin -> awg
rio -> her
rip -> qbf
riq -> nzn
rir -> mkk
ris -> bzs
rit -> fgk
riu -> blh
riv -> tru
riw -> hwu
rix -> uzu
riy -> izd
riz -> qtt
rja -> zit
rjb -> exz
rjc -> xci
rjd -> tvv
rje -> isd
rjf -> vrc
rjg -> gbn
rjh -> wen
rji -> lqj
rjj -> qqx
rjk -> bin
rjl -> nzj
rjm -> ozn
rjn -> vgz
rjo -> yrj
rjp -> ota
rjq -> zjo
rjr -> wsl
rjs -> tcy
rjt -> xiy
rju -> fit
rjv -> toe
rjw -> mkm
rjx -> smg
rjy -> not
rjz -> atu
rka -> ukc
rkb -> ysu
rkc -> jcf
rkd -> kut
rke -> kyk
rkf -> bwb
rkg -> wir
rkh -> dah
rki -> sgj
rkj -> znb
rkk -> vfi
rkl -> imz
rkm -> arz
rkn -> mpv
rko -> ipj
rkp -> vor
rkq -> vzc
rkr -> ayr
rks -> kra
rkt -> krz
rku -> nqt
rkv -> nsa
rkw -> mup
rkx -> coh
rky -> zau
rkz -> jlv
rla -> rwn
rlb -> rng
rlc -> amm
rld -> omn
rle -> bem
rlf -> cku
rlg -> hkw
rlh -> bxd
rli -> tzo
rlj -> gay
rlk -> nom
rll -> iws
rlm -> naq
rln -> xfs
rlo -> bwu
rlp -> riq
rlq -> zvx
rlr -> zjg
rls -> zlz
rlt -> lxw
rlu -> rnv
rlv -> eff
rlw -> vod
rlx -> zqy
rly -> qfc
rlz -> zib
rma -> aep
rmb -> wdc
rmc -> iob
rmd -> wjf
rme -> wkd
rmf -> khn
rmg -> nbe
rmh -> owf
rmi -> zum
rmj -> hch
rmk -> gca
rml -> jju
rmm -> rfm
rmn -> pvw
rmo -> hef
rmp -> eri
rmq -> azq
rmr -> udu
rms -> ijf
rmt -> ycs
rmu -> wbi
rmv -> lwy
rmw -> fds
rmx -> vrw
rmy -> fnn
rmz -> loi
rna -> wym
rnb -> ygh
rnc -> utt
rnd -> lde
rne -> xnn
rnf -> rfi
rng -> yhr
rnh -> tqu
rni -> ftl
rnj -> foa
rnk -> awt
rnl -> vmp
rnm -> xth
rnn -> awc
rno -> zap
rnp -> orw
rnq -> rls
rnr -> eth
rns -> xbp
rnt -> ryo
rnu -> dgd
rnv -> stv
rnw -> dot
rnx -> bwj
rny -> usx
rnz -> xrx
roa -> fqe
rob -> nzt
roc -> jqp
rod -> efk
roe -> dmd
rof -> yfa
rog -> lzh
roh -> diy
roi -> ykm
roj -> luh
rok -> fmh
rol -> fur
rom -> jdw
ron -> fzw
roo -> jap
rop -> kbi
roq -> vez
ror -> pvm
ros -> aio
rot -> fue
rou -> rkg
rov -> tke
row -> oia
rox -> flh
roy -> rlx
roz -> epg
rpa -> qiu
rpb -> bhx
rpc -> bcl
rpd -> yto
rpe -> duc
rpf -> oqy
rpg -> exh
rph -> eaj
rpi -> thj
rpj -> row
rpk -> pfm
rpl -> dpi
rpm -> api
rpn -> rkn
rpo -> mfp
rpp -> jsn
rpq -> qkc
rpr -> cmp
rps -> lkz
rpt -> ifk
rpu -> mzq
rpv -> ahv
rpw -> jto
rpx -> jwm
rpy -> ige
rpz -> fxl
rqa -> qkz
rqb -> jzp
rqc -> usc
rqd -> umr
rqe -> mog
rqf -> cln
rqg -> xef
rqh -> lmr
rqi -> axx
rqj -> jfp
rqk -> xig
rql -> kit
rqm -> ugx
rqn -> oom
rqo -> rxg
rqp -> uxm
rqq -> fbl
rqr -> yey
rqs -> suh
rqt -> vut
rqu -> ivm
rqv -> qsi
rqw -> npy
rqx -> yrw
rqy -> fvs
rqz -> ucc
rra -> pdq
rrb -> tef
rrc -> ixx
rrd -> qzd
rre -> wcm
rrf -> lpm
rrg -> chj
rrh -> xcg
rri -> ztc
rrj -> hnz
rrk -> fdb
rrl -> mcb
rrm -> yab
rrn -> smw
rro -> uud
rrp -> mcu
rrq -> iby
rrr -> zlj
rrs -> hsg
rrt -> alz
rru -> dqz
rrv -> rca
rrw -> bar
rrx -> hot
rry -> pjg
rrz -> uvq
rsa -> enn
rsb -> gql
rsc -> bkx
rsd -> dps
rse -> bou
rsf -> ebf
rsg -> vaa
rsh -> qys
rsi -> uzn
rsj -> ldz
rsk -> szs
rsl -> ywh
rsm -> bow
rsn -> gdj
rso -> jyu
rsp -> vjl
rsq -> qfu
rsr -> pnn
rss -> drg
rst -> lrn
rsu -> brn
rsv -> wjz
rsw -> zir
rsx -> ctp
rsy -> yox
rsz -> vco
rta -> fqb
rtb -> zoy
rtc -> rpd
rtd -> pzu
rte -> goz
rtf -> gai
rtg -> ose
rth -> nnx
rti -> rwh
rtj -> cvm
rtk -> uoa
rtl -> kpv
rtm -> ioo
rtn -> osz
rto -> vka
rtp -> vru
rtq -> ula
rtr -> bck
rts -> gti
rtt -> rra
rtu -> bib
rtv -> aut
rtw -> yfs
rtx -> dev
rty -> fwg
rtz -> xwc
rua -> xlq
rub -> jds
ruc -> jfy
rud -> vla
rue -> xvp
ruf -> qug
rug -> xbl
ruh -> bgv
rui -> uok
ruj -> xzt
ruk -> cjo
rul -> skj
rum -> bay
run -> ycw
ruo -> ott
rup -> shs
ruq -> xdd
rur -> lft
rus -> ekr
rut -> aof
ruu -> ylj
ruv -> dqx
ruw -> kva
rux -> jtw
ruy -> fiu
ruz -> kbl
rva -> zst
rvb -> cnn
rvc -> tkn
rvd -> lqc
rve -> hnf
rvf -> zzf
rvg -> uby
rvh -> fmx
rvi -> hcu
rvj -> puq
rvk -> icz
rvl -> yss
rvm -> bhp
rvn -> eay
rvo -> gkl
rvp -> crj
rvq -> zft
rvr -> qzg
rvs -> zed
rvt -> sok
rvu -> mvn
rvv -> ste
rvw -> wwy
rvx -> qzi
rvy -> utc
rvz -> vfy
rwa -> eei
rwb -> lxs
rwc -> yjf
rwd -> hej
rwe -> pcp
rwf -> idi
rwg -> lis
rwh -> zxt
rwi -> vbz
rwj -> fza
rwk -> fcc
rwl -> lvi
rwm -> bra
rwn -> pna
rwo -> vbk
rwp -> kvy
rwq -> esr
rwr -> oyi
rws -> lju
rwt -> vvv
rwu -> tvc
rwv -> ahh
rww -> tgj
rwx -> msg
rwy -> pod
rwz -> axr
rxa -> oke
rxb -> dtf
rxc -> dtw
rxd -> qxt
rxe -> lew
rxf -> tna
rxg -> dng
rxh -> qml
rxi -> gkj
rxj -> atc
rxk -> ykj
rxl -> wim
rxm -> dhk
rxn -> rdz
rxo -> hbz
rxp -> dti
rxq -> flq
rxr -> gok
rxs -> zsp
rxt -> ijo
rxu -> emw
rxv -> gzw
rxw -> zot
rxx -> juf
rxy -> uyx
rxz -> vvx
rya -> fzi
ryb -> rgu
ryc -> lur
ryd -> vzy
rye -> ahz
ryf -> rzr
ryg -> sxq
ryh -> jup
ryi -> kxk
ryj -> qzq
ryk -> btv
ryl -> sqr
rym -> fex
ryn -> daj
ryo -> cri
ryp -> czr
ryq -> gun
ryr -> gjl
rys -> jiu
ryt -> ppv
ryu -> teu
ryv -> ypw
ryw -> xte
ryx -> xal
ryy -> fuv
ryz -> gvl
rza -> gte
rzb -> bsn
rzc -> lqt
rzd -> bda
rze -> unt
rzf -> bah
rzg -> wgz
rzh -> ujo
rzi -> hka
rzj -> qbi
rzk -> lpg
rzl -> ycn
rzm -> nlm
rzn -> moe
rzo -> dsy
rzp -> qbb
rzq -> nri
rzr -> zpa
rzs -> uiz
rzt -> fkf
rzu -> pzw
rzv -> rfp
rzw -> zpk
rzx -> fnt
rzy -> psx
rzz -> ipi
saa -> tjk
sab -> mhm
sac -> hur
sad -> aiy
sae -> lqi
saf -> fbg
sag -> vnl
sah -> ccp
sai -> arq
saj -> aul
sak -> apx
sal -> qwh
sam -> ntc
san -> afo
sao -> xwu
sap -> gzg
saq -> lcv
sar -> fyk
sas -> kwp
sat -> ppl
sau -> kat
sav -> woz
saw -> lqz
sax -> tyf
say -> qyi
saz -> bsb
sba -> kuf
sbb -> lud
sbc -> stu
sbd -> zar
sbe -> kxb
sbf -> oto
sbg -> vbn
sbh -> zjr
sbi -> tid
sbj -> hbw
sbk -> psu
sbl -> set
sbm -> zhq
sbn -> rvg
sbo -> nrm
sbp -> pyz
sbq -> ydp
sbr -> cfn
sbs -> cpm
sbt -> omw
sbu -> btz
sbv -> gjo
sbw -> kss
sbx -> hzk
sby -> jyf
sbz -> sxp
sca -> cfu
scb -> iox
scc -> bsv
scd -> kmn
sce -> iyq
scf -> abb
scg -> kny
sch -> gwu
sci -> hyk
scj -> vyi
sck -> whs
scl -> iuo
scm -> jpq
scn -> ugd
sco -> ulc
scp -> pbd
scq -> lik
scr -> voy
scs -> bmy
sct -> pjo
scu -> wgq
scv -> mbx
scw -> qns
scx -> imw
scy -> gdg
scz -> odz
sda -> xdu
sdb -> egr
sdc -> kvl
sdd -> dkh
sde -> pff
sdf -> idr
sdg -> fqn
sdh -> vse
sdi -> ggr
sdj -> mus
sdk -> hzo
sdl -> eyq
sdm -> gey
sdn -> afy
sdo -> wle
sdp -> mjz
sdq -> uck
sdr -> dbb
sds -> wgg
sdt -> fbu
sdu -> ugs
sdv -> zhu
sdw -> lzs
sdx -> yzi
sdy -> gtt
sdz -> ppd
sea -> rmw
seb -> lqw
sec -> xkz
sed -> seo
see -> pok
sef -> rpg
seg -> xpr
seh -> sbf
sei -> eyz
sej -> jho
sek -> mpo
sel -> uil
sem -> icc
sen -> emj
seo -> ciu
sep -> gcp
seq -> dmr
ser -> yjt
ses -> art
set -> pzh
seu -> ors
sev -> dkf
sew -> gac
sex -> bcq
sey -> ded
sez -> oou
sfa -> vzb
sfb -> dcv
sfc -> adp
sfd -> tyu
sfe -> utu
sff -> jxs
sfg -> aym
sfh -> spi
sfi -> fdd
sfj -> qyb
sfk -> zfu
sfl -> lrm
sfm -> qmj
sfn -> ihq
sfo -> aqb
sfp -> dxz
sfq -> vzr
sfr -> okx
sfs -> sde
sft -> znu
sfu -> fkb
sfv -> lwu
sfw -> xnz
sfx -> cex
sfy -> tqn
sfz -> wxs
sga -> nkh
sgb -> kqs
sgc -> dio
sgd -> anq
sge -> gch
sgf -> sje
sgg -> lac
sgh -> nfq
sgi -> mdu
sgj -> dqh
sgk -> bfy
sgl -> ggk
sgm -> ygg
sgn -> czg
sgo -> thp
sgp -> obk
sgq -> vsj
sgr -> ryn
sgs -> juw
sgt -> gpq
sgu -> yfd
sgv -> gzu
sgw -> xpv
sgx -> jwu
sgy -> fqj
sgz -> kwz
sha -> cyx
shb -> aty
shc -> fyo
shd -> prh
she -> wsx
shf -> nnq
shg -> mxb
shh -> ofs
shi -> vgx
shj -> klu
shk -> hqd
shl -> zdq
shm -> btu
shn -> ate
sho -> xcz
shp -> hye
shq -> tff
shr -> gaq
shs -> ggj
sht -> gsn
shu -> dub
shv -> opq
shw -> xdp
shx -> rld
shy -> jwg
shz -> twd
sia -> xzh
sib -> ipa
sic -> zqb
sid -> fsz
sie -> pzq
sif -> xwt
sig -> ars
sih -> zbn
sii -> aft
sij -> fnu
sik -> gpt
sil -> ivp
sim -> ibl
sin -> vgd
sio -> viu
sip -> wgr
siq -> wer
sir -> kki
sis -> rei
sit -> nrs
siu -> lgb
siv -> xyv
siw -> acb
six -> nly
siy -> oig
siz -> qhj
sja -> qnu
sjb -> vnr
sjc -> sga
sjd -> orf
sje -> shu
sjf -> vcz
sjg -> rvd
sjh -> jvd
sji -> lcm
sjj -> ymn
sjk -> yos
sjl -> pix
sjm -> tkz
sjn -> afj
sjo -> jcj
sjp -> mbu
sjq -> pgg
sjr -> reg
sjs -> jmt
sjt -> nbs
sju -> yxi
sjv -> dlk
sjw -> coj
sjx -> yqz
sjy -> ivf
sjz -> nbx
ska -> xdw
skb -> ijj
skc -> njz
skd -> qgt
ske -> zpy
skf -> xzq
skg -> rwc
skh -> syt
ski -> bnl
skj -> fcn
skk -> ilu
skl -> hbg
skm -> biu
skn -> gnf
sko -> lqx
skp -> cfl
skq -> boe
skr -> heo
sks -> xmh
skt -> pqm
sku -> czv
skv -> jid
skw -> mxz
skx -> zmd
sky -> eio
skz -> sfh
sla -> cws
slb -> lsz
slc -> wwu
sld -> owl
sle -> xqb
slf -> jal
slg -> csc
slh -> lsg
sli -> iql
slj -> ifz
slk -> rym
sll -> hlt
slm -> ekm
sln -> nqy
slo -> xng
slp -> oky
slq -> qjo
slr -> rpl
sls -> ruw
slt -> urk
slu -> fep
slv -> zvg
slw -> cgx
slx -> man
sly -> hez
slz -> wtf
sma -> rbt
smb -> lpv
smc -> bmq
smd -> jmk
sme -> fet
smf -> yct
smg -> lux
smh -> ism
smi -> tcj
smj -> fdc
smk -> msq
sml -> nai
smm -> pfi
smn -> suc
smo -> nbr
smp -> jxm
smq -> eza
smr -> toz
sms -> dmi
smt -> dqm
smu -> oxg
smv -> ggs
smw -> wor
smx -> hyu
smy -> svb
smz -> eoo
sna -> xej
snb -> tel
snc -> ubh
snd -> qtz
sne -> bdh
snf -> far
sng -> jxf
snh -> ptn
sni -> xyh
snj -> hdz
snk -> gqb
snl -> tse
snm -> hoi
snn -> rtd
sno -> wbo
snp -> tpr
snq -> xzi
snr -> dfb
sns -> mqh
snt -> cww
snu -> csm
snv -> yvq
snw -> kzq
snx -> wnl
sny -> oup
snz -> xph
soa -> kak
sob -> rco
soc -> gou
sod -> yzx
soe -> sdb
sof -> zzb
sog -> aqh
soh -> vhr
soi -> roz
soj -> dls
sok -> pov
sol -> cfv
som -> vga
son -> qak
soo -> idy
sop -> epb
soq -> fub
sor -> hzd
sos -> xye
sot -> awf
sou -> krc
sov -> nmd
sow -> lxy
sox -> hdk
soy -> mdj
soz -> zlt
spa -> crt
spb -> anj
spc -> kmw
spd -> brd
spe -> jib
spf -> gvr
spg -> yih
sph -> vmi
spi -> xup
spj -> myg
spk -> srj
spl -> bop
spm -> pgn
spn -> apj
spo -> cmm
spp -> jmw
spq -> kjs
spr -> zmf
sps -> znv
spt -> xpc
spu -> xyp
spv -> qps
spw -> rnx
spx -> fgv
spy -> hcw
spz -> akf
sqa -> npq
sqb -> gjs
sqc -> kxo
sqd -> onf
sqe -> iog
sqf -> vvy
sqg -> rau
sqh -> clg
sqi -> swk
sqj -> vqh
sqk -> heh
sql -> rop
sqm -> ofa
sqn -> ezf
sqo -> zym
sqp -> nqh
sqq -> wrj
sqr -> xzv
sqs -> gnh
sqt -> xsq
squ -> exm
sqv -> zdv
sqw -> vyg
sqx -> cbf
sqy -> gdm
sqz -> wna
sra -> zrg
srb -> qdl
src -> lly
srd -> wbr
sre -> tjz
srf -> awd
srg -> qxw
srh -> njg
sri -> wsa
srj -> qut
srk -> hcq
srl -> nsm
srm -> oap
srn -> vcn
sro -> qnc
srp -> mjp
srq -> ukx
srr -> jao
srs -> pkm
srt -> ent
sru -> bue
srv -> nem
srw -> kmj
srx -> dnv
sry -> tza
srz -> eek
ssa -> skc
ssb -> guh
ssc -> cdp
ssd -> ivg
sse -> vec
ssf -> dju
ssg -> whh
ssh -> xqh
ssi -> txw
ssj -> otx
ssk -> ejj
ssl -> tqg
ssm -> nvp
ssn -> unr
sso -> akv
ssp -> zzu
ssq -> vyv
ssr -> zxd
sss -> kcp
sst -> qcp
ssu -> jtx
ssv -> foo
ssw -> tcd
ssx -> kzp
ssy -> szd
ssz -> gtw
sta -> zni
stb -> bao
stc -> jkm
std -> tki
ste -> zfc
stf -> hsm
stg -> vay
sth -> oby
sti -> zwt
stj -> nol
stk -> ygu
stl -> tdy
stm -> wnv
stn -> ald
sto -> hfh
stp -> bfg
stq -> voj
str -> cwb
sts -> hev
stt -> hrs
stu -> bdk
stv -> jic
stw -> izy
stx -> lsn
sty -> soo
stz -> xvh
sua -> may
sub -> gvi
suc -> zmk
sud -> cpu
sue -> ilh
suf -> stg
sug -> rqo
suh -> hjs
sui -> qgy
suj -> yzq
suk -> dgy
sul -> ujh
sum -> wtn
sun -> gvf
suo -> cqf
sup -> jfh
suq -> qaq
sur -> ivz
sus -> bur
sut -> ort
suu -> yqa
suv -> hld
suw -> gsv
sux -> ofn
suy -> ogf
suz -> qrw
sva -> prw
svb -> uwk
svc -> vtq
svd -> uqt
sve -> lfc
svf -> plz
svg -> diz
svh -> dwc
svi -> cxa
svj -> how
svk -> xwz
svl -> csy
svm -> ztj
svn -> arf
svo -> psl
svp -> zjx
svq -> kgz
svr -> cyf
svs -> exd
svt -> jdn
svu -> kbm
svv -> kqk
svw -> emi
svx -> cgn
svy -> kay
svz -> ows
swa -> zpz
swb -> gdv
swc -> xak
swd -> vmu
swe -> dlr
swf -> kgs
swg -> dfc
swh -> yiu
swi -> phx
swj -> uky
swk -> mlm
swl -> ztd
swm -> sxg
swn -> xsm
swo -> bzi
swp -> tkt
swq -> dek
swr -> zul
sws -> xpw
swt -> sli
swu -> jbm
swv -> zzc
sww -> zqc
swx -> syj
swy -> xgm
swz -> hla
sxa -> wdj
sxb -> yaw
sxc -> qkn
sxd -> kep
sxe -> ojv
sxf -> szz
sxg -> hxe
sxh -> kzk
sxi -> lyf
sxj -> apn
sxk -> sto
sxl -> qqc
sxm -> zcy
sxn -> eet
sxo -> xvx
sxp -> uzi
sxq -> bkv
sxr -> zms
sxs -> lfm
sxt -> ghl
sxu -> nup
sxv -> qnr
sxw -> khp
sxx -> brs
sxy -> vrp
sxz -> gco
sya -> rws
syb -> tjg
syc -> pwa
syd -> vot
sye -> fre
syf -> jmb
syg -> eem
syh -> gsh
syi -> bhi
syj -> myj
syk -> ofc
syl -> jne
sym -> dwr
syn -> agf
syo -> rky
syp -> tya
syq -> vsc
syr -> mwu
sys -> whe
syt -> igq
syu -> vme
syv -> rul
syw -> ypr
syx -> rsl
syy -> iln
syz -> fob
sza -> iof
szb -> qnd
szc -> rgs
szd -> iqy
sze -> rdv
szf -> ron
szg -> jco
szh -> qzy
szi -> gcn
szj -> ksu
szk -> xre
szl -> mlg
szm -> olj
szn -> cly
szo -> gap
szp -> uqf
szq -> ckg
szr -> nhd
szs -> gje
szt -> jpx
szu -> izw
szv -> iqq
szw -> ulx
szx -> kcv
szy -> zxh
szz -> xyk
taa -> zpl
tab -> vgr
tac -> bsp
tad -> cdy
tae -> pwk
taf -> mou
tag -> eol
tah -> ilf
tai -> deb
taj -> mex
tak -> mbl
tal -> mui
tam -> iba
tan -> rpb
tao -> snn
tap -> nqp
taq -> vwl
tar -> mse
tas -> pqp
tat -> ivd
tau -> pve
tav -> ilt
taw -> inu
tax -> otm
tay -> qlo
taz -> kcd
tba -> svl
tbb -> bxy
tbc -> eau
tbd -> lpo
tbe -> vzi
tbf -> sil
tbg -> lgj
tbh -> ysq
tbi -> brh
tbj -> ope
tbk -> qjl
tbl -> oin
tbm -> nwf
tbn -> vki
tbo -> xgn
tbp -> rny
tbq -> xsc
tbr -> jff
tbs -> jbi
tbt -> ioe
tbu -> paf
tbv -> lte
tbw -> ooe
tbx -> sus
tby -> ioy
tbz -> ork
tca -> pbn
tcb -> dhm
tcc -> mko
tcd -> xnh
tce -> cah
tcf -> eif
tcg -> nfy
tch -> lji
tci -> nix
tcj -> vhg
tck -> krb
tcl -> upk
tcm -> gxz
tcn -> gdp
tco -> zdb
tcp -> mxt
tcq -> oym
tcr -> ibk
tcs -> sxw
tct -> lim
tcu -> jyp
tcv -> zdd
tcw -> anr
tcx -> ixu
tcy -> kye
tcz -> ijn
tda -> boz
tdb -> zrt
tdc -> fao
tdd -> zbr
tde -> eko
tdf -> ptr
tdg -> gqn
tdh -> qfv
tdi -> urn
tdj -> wkf
tdk -> cps
tdl -> zfm
tdm -> ssc
tdn -> ogi
tdo -> ssb
tdp -> frc
tdq -> rwp
tdr -> vqz
tds -> tbk
tdt -> dpk
tdu -> wmb
tdv -> bsk
tdw -> lbw
tdx -> zsm
tdy -> rsj
tdz -> evs
tea -> vtl
teb -> gih
tec -> dne
ted -> ape
tee -> avd
tef -> adj
teg -> tzy
teh -> aba
tei -> tik
tej -> gia
tek -> mhc
tel -> awm
tem -> iqv
ten -> zxl
teo -> muj
tep -> mws
teq -> ytl
ter -> xzj
tes -> kfn
tet -> khg
teu -> iau
tev -> myd
tew -> iut
tex -> qcl
tey -> jij
tez -> asx
tfa -> jhf
tfb -> fti
tfc -> rww
tfd -> qkx
tfe -> tok
tff -> qsr
tfg -> zjw
tfh -> wuk
tfi -> yge
tfj -> yru
tfk -> phw
tfl -> kbg
tfm -> hst
tfn -> ufs
tfo -> qup
tfp -> ukr
tfq -> nvx
tfr -> zvr
tfs -> ggm
tft -> cts
tfu -> qio
tfv -> wjw
tfw -> jkv
tfx -> yrg
tfy -> jbs
tfz -> xmb
tga -> qie
tgb -> ojc
tgc -> ytp
tgd -> xuj
tge -> rus
tgf -> gru
tgg -> vvl
tgh -> yhh
tgi -> tee
tgj -> rcm
tgk -> ebo
tgl -> ngd
tgm -> bpn
tgn -> xgy
tgo -> snz
tgp -> soa
tgq -> hbq
tgr -> prs
tgs -> rsd
tgt -> ghi
tgu -> yqc
tgv -> wae
tgw -> bwa
tgx -> cgl
tgy -> rad
tgz -> fix
tha -> nhq
thb -> sob
thc -> djn
thd -> fiw
the -> vah
thf -> cvy
thg -> wak
thh -> frk
thi -> nnc
thj -> xwv
thk -> lxa
thl -> fut
thm -> hsb
thn -> xrc
tho -> xts
thp -> iyb
thq -> gli
thr -> zqe
ths -> owx
tht -> qyo
thu -> ndm
thv -> qxe
thw -> aqf
thx -> khs
thy -> ojf
thz -> eml
tia -> dbc
tib -> cqx
tic -> aku
tid -> zrc
tie -> qgr
tif -> uau
tig -> ztr
tih -> eji
tii -> jnw
tij -> vye
tik -> rie
til -> whx
tim -> puv
tin -> uzb
tio -> gmr
tip -> twz
tiq -> mhw
tir -> dga
tis -> jch
tit -> nnh
tiu -> xow
tiv -> xji
tiw -> lbv
tix -> pev
tiy -> diu
tiz -> ugw
tja -> knm
tjb -> qbw
tjc -> lvy
tjd -> yoc
tje -> hrv
tjf -> reu
tjg -> skq
tjh -> gii
tji -> ujl
tjj -> wwc
tjk -> ini
tjl -> ijv
tjm -> ujj
tjn -> moc
tjo -> uis
tjp -> tls
tjq -> jrg
tjr -> gyn
tjs -> bru
tjt -> wmm
tju -> kkw
tjv -> kax
tjw -> mkq
tjx -> kzz
tjy -> twr
tjz -> shx
tka -> mjm
tkb -> ipn
tkc -> reo
tkd -> zfq
tke -> qes
tkf -> uwv
tkg -> qfo
tkh -> vqf
tki -> ceg
tkj -> elg
tkk -> byx
tkl -> nqa
tkm -> sfd
tkn -> vty
tko -> zao
tkp -> prj
tkq -> kle
tkr -> yec
tks -> iyn
tkt -> roq
tku -> wcq
tkv -> pzv
tkw -> bry
tkx -> yqv
tky -> mmn
tkz -> qat
tla -> spo
tlb -> rej
tlc -> ncp
tld -> kpb
tle -> kdg
tlf -> ida
tlg -> vie
tlh -> tvn
tli -> luo
tlj -> kis
tlk -> plt
tll -> fqp
tlm -> aab
tln -> bhs
tlo -> ffk
tlp -> tsi
tlq -> qpo
tlr -> ngq
tls -> vrl
tlt -> fox
tlu -> lsh
tlv -> fbo
tlw -> unq
tlx -> wry
tly -> fup
tlz -> zve
tma -> lsc
tmb -> brk
tmc -> nca
tmd -> zys
tme -> ipd
tmf -> wwd
tmg -> qhk
tmh -> vwv
tmi -> ikd
tmj -> bhm
tmk -> jcn
tml -> aru
tmm -> tco
tmn -> wnr
tmo -> ueu
tmp -> gka
tmq -> jwb
tmr -> qgn
tms -> sey
tmt -> xsg
tmu -> zyr
tmv -> eqj
tmw -> amu
tmx -> wuw
tmy -> cqp
tmz -> kaz
tna -> oor
tnb -> faq
tnc -> wxf
tnd -> csn
tne -> rsf
tnf -> mru
tng -> jri
tnh -> hfz
tni -> dyq
tnj -> umy
tnk -> lan
tnl -> mcr
tnm -> xbm
tnn -> cuv
tno -> wog
tnp -> bkt
tnq -> fef
tnr -> ptt
tns -> stz
tnt -> mew
tnu -> dfa
tnv -> lqq
tnw -> ijh
tnx -> ofd
tny -> qci
tnz -> uvx
toa -> dnl
tob -> yzd
toc -> bsm
tod -> zmp
toe -> qmi
tof -> cvc
tog -> cgh
toh -> lhh
toi -> fxy
toj -> esl
tok -> mqn
tol -> pqk
tom -> tep
ton -> tes
too -> tbl
top -> xlm
toq -> iaq
tor -> vkg
tos -> ryt
tot -> vpa
tou -> qmd
tov -> gcw
tow -> ucv
tox -> vem
toy -> fdl
toz -> eix
tpa -> alw
tpb -> kui
tpc -> bch
tpd -> lap
tpe -> gho
tpf -> wuc
tpg -> aqd
tph -> xvz
tpi -> cab
tpj -> maf
tpk -> cpj
tpl -> brz
tpm -> hco
tpn -> mtr
tpo -> pqy
tpp -> ijz
tpq -> fwe
tpr -> jxt
tps -> owi
tpt -> ajm
tpu -> gpr
tpv -> kvb
tpw -> gdz
tpx -> wjd
tpy -> hqc
tpz -> qyv
tqa -> evr
tqb -> uam
tqc -> gjr
tqd -> xba
tqe -> wiq
tqf -> tdc
tqg -> qvm
tqh -> caf
tqi -> lqr
tqj -> pgb
tqk -> mkr
tql -> zmc
tqm -> ffp
tqn -> ovg
tqo -> oet
tqp -> syd
tqq -> gld
tqr -> pxm
tqs -> bel
tqt -> mvu
tqu -> tvj
tqv -> xkn
tqw -> oda
tqx -> beb
tqy -> dgp
tqz -> gwa
tra -> kvc
trb -> lzw
trc -> cyq
trd -> wqq
tre -> hac
trf -> yza
trg -> rbw
trh -> fgi
tri -> xpp
trj -> hxz
trk -> enf
trl -> dli
trm -> gkh
trn -> zbf
tro -> qrz
trp -> ifx
trq -> zgf
trr -> brm
trs -> jfj
trt -> zfr
tru -> mmf
trv -> foe
trw -> isi
trx -> ryu
try -> rgx
trz -> joi
tsa -> ykz
tsb -> eqr
tsc -> udq
tsd -> ifh
tse -> kpk
tsf -> asj
tsg -> osh
tsh -> mau
tsi -> mol
tsj -> zld
tsk -> atz
tsl -> jcq
tsm -> dxh
tsn -> lpq
tso -> ftt
tsp -> cco
tsq -> bpl
tsr -> dov
tss -> cke
tst -> pdg
tsu -> ngy
tsv -> ckf
tsw -> cni
tsx -> kuu
tsy -> fee
tsz -> llc
tta -> jsu
ttb -> wlo
ttc -> iml
ttd -> czm
tte -> edv
ttf -> prt
ttg -> uzm
tth -> vvq
tti -> yph
ttj -> rza
ttk -> rpa
ttl -> zcw
ttm -> oum
ttn -> zzo
tto -> yxc
ttp -> ojh
ttq -> gnc
ttr -> idh
tts -> iwz
ttt -> lej
ttu -> sch
ttv -> txb
ttw -> cwf
ttx -> uhp
tty -> dzy
ttz -> wsc
tua -> sun
tub -> orq
tuc -> rwd
tud -> ckj
tue -> hbj
tuf -> qvp
tug -> ook
tuh -> agr
tui -> ylv
tuj -> dmo
tuk -> fst
tul -> hfn
tum -> idj
tun -> kce
tuo -> vsp
tup -> dsn
tuq -> ufn
tur -> zac
tus -> oqk
tut -> kpe
tuu -> ryl
tuv -> log
tuw -> mao
tux -> kes
tuy -> lhq
tuz -> ljy
tva -> tsv
tvb -> klc
tvc -> rel
tvd -> blv
tve -> dfy
tvf -> uzr
tvg -> knt
tvh -> vbo
tvi -> xdm
tvj -> yvb
tvk -> kbk
tvl -> jsj
tvm -> kkp
tvn -> xjg
tvo -> nzu
tvp -> pef
tvq -> iix
tvr -> wzr
tvs -> gjh
tvt -> ksx
tvu -> bqp
tvv -> rrx
tvw -> ucm
tvx -> oxa
tvy -> rrp
tvz -> llg
twa -> hlx
twb -> uto
twc -> vcv
twd -> bvq
twe -> bty
twf -> amh
twg -> nms
twh -> ijl
twi -> gdr
twj -> doc
twk -> rtj
twl -> qox
twm -> xxw
twn -> cok
two -> dch
twp -> gzi
twq -> snw
twr -> bca
tws -> uxv
twt -> njq
twu -> gll
twv -> mqg
tww -> vyk
twx -> gaz
twy -> hml
twz -> fkt
txa -> eua
txb -> vhi
txc -> una
txd -> hca
txe -> vkn
txf -> jrr
txg -> ziw
txh -> bvd
txi -> zsx
txj -> bzf
txk -> flo
txl -> vjg
txm -> xkj
txn -> edx
txo -> ofb
txp -> wxt
txq -> fak
txr -> fel
txs -> uko
txt -> qgg
txu -> tbm
txv -> gyj
txw -> pjh
txx -> ano
txy -> jii
txz -> djs
tya -> rbc
tyb -> sjw
tyc -> jxz
tyd -> cwe
tye -> eec
tyf -> vwd
tyg -> gnm
tyh -> dqj
tyi -> rvy
tyj -> inh
tyk -> gvh
tyl -> zpp
tym -> alf
tyn -> qjw
tyo -> xhm
typ -> ltp
tyq -> zfp
tyr -> crl
tys -> qdz
tyt -> nwq
tyu -> oiu
tyv -> xhd
tyw -> yls
tyx -> iry
tyy -> bve
tyz -> ven
tza -> ptp
tzb -> vvi
tzc -> fkz
tzd -> fes
tze -> hjd
tzf -> fms
tzg -> khz
tzh -> bpc
tzi -> osa
tzj -> yck
tzk -> iny
tzl -> opa
tzm -> syk
tzn -> xgz
tzo -> wto
tzp -> uoo
tzq -> rci
tzr -> onj
tzs -> wkv
tzt -> vug
tzu -> ixs
tzv -> vur
tzw -> pxg
tzx -> jwj
tzy -> pti
tzz -> mrw
uaa -> lsm
uab -> xrm
uac -> zsi
uad -> ehe
uae -> ayi
uaf -> cxf
uag -> dgo
uah -> oit
uai -> dja
uaj -> bhu
uak -> syy
ual -> qdb
uam -> mbi
uan -> daf
uao -> buv
uap -> kfb
uaq -> tcu
uar -> tcb
uas -> zoe
uat -> bqg
uau -> qbc
uav -> bab
uaw -> ceq
uax -> ajg
uay -> dwx
uaz -> xfy
uba -> hyq
ubb -> pwp
ubc -> jsd
ubd -> wrr
ube -> nsx
ubf -> amz
ubg -> mfk
ubh -> xem
ubi -> afu
ubj -> gvz
ubk -> wyq
ubl -> abi
ubm -> zlq
ubn -> adu
ubo -> mdy
ubp -> ycl
ubq -> tdd
ubr -> pdl
ubs -> fxd
ubt -> cof
ubu -> huw
ubv -> mjg
ubw -> bhk
ubx -> dgb
uby -> vve
ubz -> rud
uca -> anf
ucb -> jux
ucc -> ykl
ucd -> auq
uce -> enq
ucf -> pog
ucg -> zad
uch -> vun
uci -> czj
ucj -> vtj
uck -> ebh
ucl -> qwm
ucm -> etj
ucn -> lpa
uco -> rgw
ucp -> hgi
ucq -> eoz
ucr -> igi
ucs -> tkb
uct -> xli
ucu -> ago
ucv -> jrp
ucw -> tqw
ucx -> bif
ucy -> vxt
ucz -> wvo
uda -> zrb
udb -> zuz
udc -> hmf
udd -> vif
ude -> sac
udf -> haa
udg -> bej
udh -> fbh
udi -> eap
udj -> czz
udk -> zya
udl -> erh
udm -> ezc
udn -> mag
udo -> ugt
udp -> cax
udq -> bbn
udr -> vfs
uds -> qtw
udt -> soi
udu -> rcn
udv -> zkc
udw -> mne
udx -> zjl
udy -> rtq
udz -> vpu
uea -> san
ueb -> csf
uec -> vnd
ued -> yax
uee -> bix
uef -> yun
ueg -> mdz
ueh -> nrq
uei -> cpe
uej -> jng
uek -> ser
uel -> jkk
uem -> mff
uen -> pmr
ueo -> yxj
uep -> olz
ueq -> pry
uer -> ond
ues -> mte
uet -> ofq
ueu -> ajz
uev -> xei
uew -> hbi
uex -> ofj
uey -> wzg
uez -> yzy
ufa -> txp
ufb -> xwm
ufc -> vef
ufd -> wkr
ufe -> qws
uff -> hnt
ufg -> jeh
ufh -> cut
ufi -> xxu
ufj -> nhr
ufk -> ozf
ufl -> yuf
ufm -> mvd
ufn -> mfn
ufo -> trl
ufp -> opg
ufq -> obh
ufr -> duu
ufs -> omb
uft -> umz
ufu -> tgh
ufv -> usb
ufw -> ftk
ufx -> lxz
ufy -> ipz
ufz -> msw
uga -> sxo
ugb -> nne
ugc -> ssp
ugd -> spg
uge -> hfd
ugf -> fot
ugg -> lyx
ugh -> gha
ugi -> syr
ugj -> lhs
ugk -> obr
ugl -> kzc
ugm -> jgd
ugn -> guk
ugo -> mib
ugp -> xvy
ugq -> mlw
ugr -> jxe
ugs -> drm
ugt -> ehn
ugu -> atn
ugv -> iio
ugw -> bjw
ugx -> ybx
ugy -> ber
ugz -> mzy
uha -> omt
uhb -> brb
uhc -> ggp
uhd -> dhy
uhe -> two
uhf -> ccy
uhg -> jnj
uhh -> knf
uhi -> dpa
uhj -> mot
uhk -> fqh
uhl -> hoc
uhm -> uac
uhn -> nuk
uho -> isv
uhp -> byy
uhq -> ruq
uhr -> eps
uhs -> txg
uht -> qda
uhu -> zfx
uhv -> syc
uhw -> ypb
uhx -> hae
uhy -> vhb
uhz -> ack
uia -> aqa
uib -> ffx
uic -> xik
uid -> vri
uie -> igr
uif -> jwa
uig -> grv
uih -> fyu
uii -> kfi
uij -> ada
uik -> roi
uil -> wdv
uim -> exq
uin -> uey
uio -> ofo
uip -> ojp
uiq -> xqo
uir -> hrm
uis -> jwp
uit -> ecx
uiu -> yyt
uiv -> dyr
uiw -> fys
uix -> yjp
uiy -> iug
uiz -> nso
uja -> zph
ujb -> iyt
ujc -> yqj
ujd -> doe
uje -> zbg
ujf -> ddf
ujg -> yfq
ujh -> nta
uji -> rvp
ujj -> puu
ujk -> iuj
ujl -> xxq
ujm -> bim
ujn -> tlo
ujo -> liw
ujp -> bjn
ujq -> ube
ujr -> jwx
ujs -> vci
ujt -> loh
uju -> arj
ujv -> joy
ujw -> gwh
ujx -> qjq
ujy -> uzt
ujz -> nak
uka -> zhl
ukb -> ckv
ukc -> tcg
ukd -> pdr
uke -> cmh
ukf -> qev
ukg -> dta
ukh -> mpz
uki -> irc
ukj -> qse
ukk -> dug
ukl -> wxi
ukm -> cgb
ukn -> omx
uko -> jrf
ukp -> bnt
ukq -> sau
ukr -> vpg
uks -> twk
ukt -> wtv
uku -> lzm
ukv -> oop
ukw -> jhd
ukx -> ryz
uky -> dwb
ukz -> wjp
ula -> gqv
ulb -> nnd
ulc -> weq
uld -> lom
ule -> ghd
ulf -> iqo
ulg -> uaj
ulh -> xnf
uli -> gts
ulj -> pxe
ulk -> wng
ull -> jyr
ulm -> ipq
uln -> tal
ulo -> rgm
ulp -> gdl
ulq -> zwn
ulr -> saz
uls -> xyo
ult -> wkb
ulu -> ipc
ulv -> xtx
ulw -> sxk
ulx -> nlx
uly -> azz
ulz -> mwt
uma -> yxt
umb -> peb
umc -> key
umd -> azp
ume -> hny
umf -> jaf
umg -> sxe
umh -> ike
umi -> hfg
umj -> hrk
umk -> onc
uml -> qmn
umm -> cma
umn -> nvb
umo -> fym
ump -> iae
umq -> cix
umr -> eqt
ums -> xpj
umt -> qjr
umu -> afd
umv -> otz
umw -> rpf
umx -> wfe
umy -> kjw
umz -> wuj
una -> hhb
unb -> xvl
unc -> zlu
und -> grx
une -> lnc
unf -> qxo
ung -> zho
unh -> ubq
uni -> oej
unj -> upo
unk -> wcs
unl -> qff
unm -> ibc
unn -> fbw
uno -> hlf
unp -> wwb
unq -> ggl
unr -> nio
uns -> cva
unt -> khu
unu -> xsy
unv -> brw
unw -> zws
unx -> awi
uny -> wvu
unz -> tsq
uoa -> bam
uob -> znh
uoc -> hal
uod -> rmm
uoe -> yuq
uof -> rgy
uog -> sit
uoh -> olv
uoi -> vwq
uoj -> shh
uok -> nwi
uol -> irs
uom -> ozd
uon -> fta
uoo -> sjh
uop -> phi
uoq -> miy
uor -> nch
uos -> zjj
uot -> tjw
uou -> msz
uov -> urh
uow -> zcb
uox -> frh
uoy -> jza
uoz -> zwf
upa -> vqp
upb -> nbp
upc -> xzw
upd -> mqx
upe -> lpl
upf -> xgg
upg -> btl
uph -> jkl
upi -> cmy
upj -> uyf
upk -> uer
upl -> bjt
upm -> fwk
upn -> siy
upo -> yuu
upp -> wao
upq -> voo
upr -> low
ups -> dca
upt -> pfb
upu -> kcs
upv -> zfs
upw -> wcj
upx -> oty
upy -> bud
upz -> sqj
uqa -> xtg
uqb -> lqb
uqc -> guj
uqd -> gqf
uqe -> qtl
uqf -> tfr
uqg -> ext
uqh -> zbc
uqi -> dbt
uqj -> tiz
uqk -> vpk
uql -> qmw
uqm -> exy
uqn -> mof
uqo -> cys
uqp -> zde
uqq -> krr
uqr -> kvx
uqs -> xqc
uqt -> wvp
uqu -> bfv
uqv -> dfp
uqw -> swq
uqx -> zwb
uqy -> msk
uqz -> wrd
ura -> wrh
urb -> djf
urc -> qus
urd -> hpl
ure -> jec
urf -> xxi
urg -> pku
urh -> xxb
uri -> nyw
urj -> qtb
urk -> khh
url -> ouw
urm -> eyd
urn -> qme
uro -> dbj
urp -> huq
urq -> wey
urr -> vbc
urs -> nhs
urt -> dpq
uru -> vjo
urv -> jgw
urw -> oyw
urx -> lze
ury -> fmy
urz -> wxp
usa -> dvb
usb -> zbv
usc -> nfd
usd -> epx
use -> lyp
usf -> rhd
usg -> nvz
ush -> yly
usi -> tky
usj -> qyu
usk -> unn
usl -> inq
usm -> pdj
usn -> fkh
uso -> gnq
usp -> wum
usq -> cjx
usr -> oqa
uss -> kbp
ust -> efu
usu -> wqa
usv -> puk
usw -> kme
usx -> trb
usy -> vuv
usz -> uex
uta -> xuc
utb -> bxo
utc -> ufj
utd -> ltk
ute -> too
utf -> hzx
utg -> tfq
uth -> tbu
uti -> ykq
utj -> umx
utk -> doo
utl -> rnz
utm -> nvm
utn -> iod
uto -> usq
utp -> xlu
utq -> tew
utr -> oqu
uts -> lym
utt -> lcd
utu -> gbb
utv -> pjm
utw -> zbj
utx -> lpi
uty -> evq
utz -> pzm
uua -> oxw
uub -> syw
uuc -> ibq
uud -> ywd
uue -> yyr
uuf -> pax
uug -> wji
uuh -> cyo
uui -> ogz
uuj -> vdi
uuk -> rlw
uul -> ufy
uum -> zqk
uun -> gow
uuo -> sfn
uup -> rvh
uuq -> evy
uur -> mav
uus -> sme
uut -> rfv
uuu -> zgb
uuv -> zyf
uuw -> hpj
uux -> khq
uuy -> sbe
uuz -> cop
uva -> lfl
uvb -> jhl
uvc -> len
uvd -> zdl
uve -> opp
uvf -> cau
uvg -> utl
uvh -> ead
uvi -> fdq
uvj -> lif
uvk -> lri
uvl -> oca
uvm -> xfk
uvn -> jdk
uvo -> bmv
uvp -> chf
uvq -> idp
uvr -> sex
uvs -> men
uvt -> erm
uvu -> xnw
uvv -> fxw
uvw -> arn
uvx -> xus
uvy -> qrt
uvz -> leu
uwa -> eoq
uwb -> efh
uwc -> ouh
uwd -> mmi
uwe -> iek
uwf -> vuj
uwg -> eul
uwh -> hxt
uwi -> gie
uwj -> cdc
uwk -> azu
uwl -> nyn
uwm -> kqw
uwn -> syo
uwo -> lxg
uwp -> fkq
uwq -> yzm
uwr -> zmb
uws -> evz
uwt -> jiv
uwu -> lys
uwv -> zua
uww -> hey
uwx -> mpm
uwy -> phq
uwz -> hmj
uxa -> ftu
uxb -> fal
uxc -> sof
uxd -> irp
uxe -> zyy
uxf -> egz
uxg -> gwf
uxh -> duk
uxi -> zgz
uxj -> tte
uxk -> dgz
uxl -> rjp
uxm -> hrp
uxn -> ulz
uxo -> jgm
uxp -> mes
uxq -> hcx
uxr -> tta
uxs -> sin
uxt -> qdv
uxu -> frr
uxv -> som
uxw -> zcu
uxx -> icl
uxy -> gdk
uxz -> lcs
uya -> ciq
uyb -> cvw
uyc -> xat
uyd -> dtx
uye -> ngj
uyf -> iel
uyg -> ilx
uyh -> jqk
uyi -> bpe
uyj -> oxh
uyk -> rfz
uyl -> lrv
uym -> hry
uyn -> tcz
uyo -> rhf
uyp -> kwf
uyq -> oyz
uyr -> zsy
uys -> tow
uyt -> qjk
uyu -> nxa
uyv -> fsj
uyw -> nml
uyx -> urf
uyy -> xnd
uyz -> mcn
uza -> sfl
uzb -> yaj
uzc -> ofp
uzd -> ati
uze -> uxl
uzf -> lvv
uzg -> lqv
uzh -> zec
uzi -> piw
uzj -> mem
uzk -> wnz
uzl -> oem
uzm -> rep
uzn -> xvb
uzo -> iqd
uzp -> pwm
uzq -> teh
uzr -> vnt
uzs -> cpx
uzt -> nfj
uzu -> jqt
uzv -> qag
uzw -> twg
uzx -> dab
uzy -> rqn
uzz -> hsj
vaa -> god
vab -> bls
vac -> rdt
vad -> bnh
vae -> gmb
vaf -> yoi
vag -> tns
vah -> kdz
vai -> qlw
vaj -> wkq
vak -> yqy
val -> fjt
vam -> yak
van -> kdq
vao -> npg
vap -> xki
vaq -> vnq
var -> hmr
vas -> kdl
vat -> hbu
vau -> quy
vav -> ynd
vaw -> ojq
vax -> dce
vay -> ehk
vaz -> dvd
vba -> ugn
vbb -> utf
vbc -> ciz
vbd -> jvt
vbe -> ftm
vbf -> rqp
vbg -> mle
vbh -> ytk
vbi -> emk
vbj -> zmw
vbk -> bsw
vbl -> yse
vbm -> let
vbn -> hoo
vbo -> bap
vbp -> sjy
vbq -> zmu
vbr -> tzt
vbs -> tdn
vbt -> afg
vbu -> hmw
vbv -> mzx
vbw -> utz
vbx -> qln
vby -> apq
vbz -> fei
vca -> bms
vcb -> fwm
vcc -> vgk
vcd -> tyo
vce -> xms
vcf -> ukm
vcg -> cft
vch -> fjp
vci -> wzw
vcj -> ddb
vck -> iqw
vcl -> tdk
vcm -> asi
vcn -> idu
vco -> buq
vcp -> tit
vcq -> yxb
vcr -> qpt
vcs -> xpy
vct -> nwy
vcu -> zqn
vcv -> lug
vcw -> nrd
vcx -> dyj
vcy -> zwi
vcz -> gzl
vda -> beq
vdb -> hgr
vdc -> odp
vdd -> kni
vde -> yea
vdf -> rea
vdg -> dae
vdh -> eui
vdi -> pvc
vdj -> tip
vdk -> bcy
vdl -> ejx
vdm -> obf
vdn -> ggb
vdo -> qvj
vdp -> swy
vdq -> xvk
vdr -> vev
vds -> sxz
vdt -> fkc
vdu -> qzm
vdv -> gxh
vdw -> bla
vdx -> qgw
vdy -> hgc
vdz -> enb
vea -> vuo
veb -> vum
vec -> qkb
ved -> flv
vee -> agy
vef -> igb
veg -> pgc
veh -> uti
vei -> uja
vej -> gjf
vek -> iey
vel -> oru
vem -> jzc
ven -> pfy
veo -> hyg
vep -> dht
veq -> umi
ver -> hhr
ves -> jjd
vet -> cka
veu -> mcf
vev -> ffa
vew -> inw
vex -> oyl
vey -> dqu
vez -> kqt
vfa -> tct
vfb -> qdw
vfc -> enj
vfd -> hfc
vfe -> bph
vff -> fjh
vfg -> acq
vfh -> auk
vfi -> nuv
vfj -> aih
vfk -> vft
vfl -> sfu
vfm -> yjd
vfn -> tkg
vfo -> cip
vfp -> qez
vfq -> awx
vfr -> pyc
vfs -> czl
vft -> tsr
vfu -> med
vfv -> tlc
vfw -> rsr
vfx -> dcf
vfy -> byt
vfz -> gef
vga -> onn
vgb -> mkl
vgc -> qxh
vgd -> coc
vge -> itm
vgf -> nfn
vgg -> lzy
vgh -> xrp
vgi -> buu
vgj -> ubj
vgk -> ymp
vgl -> uym
vgm -> ryd
vgn -> dym
vgo -> blu
vgp -> lno
vgq -> txt
vgr -> bpr
vgs -> tpj
vgt -> jhz
vgu -> dra
vgv -> xsi
vgw -> qyq
vgx -> kvq
vgy -> eyj
vgz -> afa
vha -> zip
vhb -> xib
vhc -> fpw
vhd -> nrp
vhe -> xpt
vhf -> ckq
vhg -> ust
vhh -> nbw
vhi -> fwj
vhj -> byw
vhk -> txi
vhl -> npk
vhm -> lsp
vhn -> tjy
vho -> nhz
vhp -> kym
vhq -> mya
vhr -> wfp
vhs -> hrc
vht -> fry
vhu -> jsx
vhv -> slr
vhw -> hbf
vhx -> lgo
vhy -> vpi
vhz -> glb
via -> joq
vib -> cbn
vic -> cgw
vid -> shk
vie -> hop
vif -> nhb
vig -> sym
vih -> tfi
vii -> skf
vij -> hfp
vik -> fvc
vil -> gqw
vim -> ngc
vin -> bav
vio -> tcs
vip -> odo
viq -> kpf
vir -> yoz
vis -> gmm
vit -> fij
viu -> jyn
viv -> zhh
viw -> gut
vix -> uwa
viy -> ade
viz -> nmw
vja -> tih
vjb -> xud
vjc -> rne
vjd -> vsl
vje -> vvt
vjf -> pqf
vjg -> xcx
vjh -> qlq
vji -> woa
vjj -> hil
vjk -> mul
vjl -> lec
vjm -> mfb
vjn -> cvl
vjo -> amv
vjp -> dbl
vjq -> hbt
vjr -> ulp
vjs -> mts
vjt -> fpa
vju -> xtk
vjv -> eyw
vjw -> uan
vjx -> sza
vjy -> idv
vjz -> sgu
vka -> ywk
vkb -> dvw
vkc -> gup
vkd -> zvf
vke -> pzd
vkf -> jut
vkg -> nzg
vkh -> tkl
vki -> buf
vkj -> tsz
vkk -> zsz
vkl -> zby
vkm -> hva
vkn -> muo
vko -> bxq
vkp -> dzh
vkq -> ztz
vkr -> xzn
vks -> qih
vkt -> pji
vku -> wel
vkv -> jjt
vkw -> hqh
vkx -> kdk
vky -> uaq
vkz -> auh
vla -> ddt
vlb -> gby
vlc -> vlj
vld -> bng
vle -> ulg
vlf -> odq
vlg -> dbu
vlh -> evh
vli -> hfx
vlj -> uoq
vlk -> ihk
vll -> wjm
vlm -> ewt
vln -> yqq
vlo -> oon
vlp -> hwp
vlq -> jdf
vlr -> ewe
vls -> xcv
vlt -> usk
vlu -> seq
vlv -> gyo
vlw -> bjv
vlx -> tie
vly -> zpw
vlz -> ptv
vma -> mjy
vmb -> eqv
vmc -> zoz
vmd -> qgo
vme -> myp
vmf -> drr
vmg -> dzn
vmh -> ddh
vmi -> oal
vmj -> jke
vmk -> rbq
vml -> bnx
vmm -> vau
vmn -> cmr
vmo -> aqr
vmp -> sjt
vmq -> ilk
vmr -> iyf
vms -> zkt
vmt -> zze
vmu -> aeb
vmv -> aub
vmw -> tgb
vmx -> tle
vmy -> ojl
vmz -> wch
vna -> bfo
vnb -> nna
vnc -> lal
vnd -> smn
vne -> sug
vnf -> lse
vng -> viv
vnh -> iwt
vni -> sue
vnj -> mjr
vnk -> xuh
vnl -> rnu
vnm -> ofy
vnn -> qwn
vno -> tqc
vnp -> ncr
vnq -> pug
vnr -> jdj
vns -> uwt
vnt -> pvq
vnu -> mej
vnv -> ali
vnw -> kfw
vnx -> eiu
vny -> alg
vnz -> rgl
voa -> eqo
vob -> eku
voc -> fby
vod -> ecf
voe -> okw
vof -> yms
vog -> yxh
voh -> arw
voi -> cqi
voj -> fwr
vok -> rwo
vol -> rkw
vom -> kls
von -> ptz
voo -> sgq
vop -> tun
voq -> ddu
vor -> uno
vos -> gxt
vot -> ebc
vou -> gme
vov -> tpn
vow -> gtp
vox -> qpj
voy -> say
voz -> qnl
vpa -> jwl
vpb -> vee
vpc -> kws
vpd -> uia
vpe -> mak
vpf -> nwu
vpg -> lhz
vph -> rgn
vpi -> lwx
vpj -> vmk
vpk -> kzy
vpl -> rru
vpm -> ldl
vpn -> vck
vpo -> xfw
vpp -> jqe
vpq -> adw
vpr -> kag
vps -> wcy
vpt -> ler
vpu -> qqb
vpv -> imp
vpw -> iho
vpx -> beh
vpy -> jel
vpz -> ewv
vqa -> uge
vqb -> rpx
vqc -> hzj
vqd -> ijt
vqe -> vdu
vqf -> czx
vqg -> jci
vqh -> ayg
vqi -> zjy
vqj -> brj
vqk -> psa
vql -> vch
vqm -> wdk
vqn -> vhu
vqo -> ylo
vqp -> nif
vqq -> vav
vqr -> zex
vqs -> edu
vqt -> szr
vqu -> tpd
vqv -> icq
vqw -> iac
vqx -> ime
vqy -> ten
vqz -> ipv
vra -> src
vrb -> gxj
vrc -> gmv
vrd -> tjo
vre -> ihs
vrf -> apg
vrg -> ziz
vrh -> pub
vri -> krv
vrj -> ubf
vrk -> zka
vrl -> xxs
vrm -> azt
vrn -> zak
vro -> jtq
vrp -> yjm
vrq -> dgt
vrr -> kyn
vrs -> lzu
vrt -> lra
vru -> szy
vrv -> nmm
vrw -> bmp
vrx -> hon
vry -> unj
vrz -> nyz
vsa -> fmd
vsb -> vqw
vsc -> gam
vsd -> qyp
vse -> zfk
vsf -> ueg
vsg -> who
vsh -> ibh
vsi -> kpq
vsj -> jzw
vsk -> asz
vsl -> cnc
vsm -> hkk
vsn -> kad
vso -> daa
vsp -> kri
vsq -> qzw
vsr -> jdd
vss -> qro
vst -> xen
vsu -> fbq
vsv -> ayy
vsw -> ywx
vsx -> cfj
vsy -> dst
vsz -> yeb
vta -> stt
vtb -> gev
vtc -> ert
vtd -> cgt
vte -> gwt
vtf -> rcz
vtg -> nlr
vth -> ael
vti -> gqo
vtj -> opf
vtk -> irl
vtl -> lst
vtm -> hyt
vtn -> ybs
vto -> utb
vtp -> dww
vtq -> wuo
vtr -> vpx
vts -> nyh
vtt -> rha
vtu -> kuy
vtv -> xzp
vtw -> yvp
vtx -> vbl
vty -> ecm
vtz -> wkh
vua -> oxk
vub -> ivv
vuc -> tyv
vud -> kxi
vue -> cic
vuf -> urs
vug -> djh
vuh -> aia
vui -> grn
vuj -> lls
vuk -> jqa
vul -> twv
vum -> cda
vun -> nli
vuo -> wce
vup -> yoo
vuq -> wfv
vur -> nhf
vus -> kin
vut -> ypo
vuu -> jyk
vuv -> vrm
vuw -> jsg
vux -> qbv
vuy -> fnh
vuz -> xdl
vva -> dwy
vvb -> smd
vvc -> xqy
vvd -> adc
vve -> gcl
vvf -> jfz
vvg -> ehx
vvh -> jtd
vvi -> nst
vvj -> avr
vvk -> aln
vvl -> hxy
vvm -> hpk
vvn -> cgy
vvo -> qfp
vvp -> elr
vvq -> egb
vvr -> dbr
vvs -> sws
vvt -> yte
vvu -> oln
vvv -> lbq
vvw -> ofk
vvx -> cgq
vvy -> xhf
vvz -> nzv
vwa -> dvn
vwb -> org
vwc -> jgo
vwd -> xah
vwe -> xhs
vwf -> bcp
vwg -> pos
vwh -> xge
vwi -> bmb
vwj -> kkl
vwk -> gnt
vwl -> dcq
vwm -> wxo
vwn -> onr
vwo -> bhb
vwp -> ehz
vwq -> bto
vwr -> rnf
vws -> jzl
vwt -> tbn
vwu -> apy
vwv -> gjp
vww -> mev
vwx -> hnw
vwy -> lth
vwz -> dkd
vxa -> rgv
vxb -> xty
vxc -> gta
vxd -> xfv
vxe -> jow
vxf -> dno
vxg -> ymf
vxh -> keq
vxi -> pwg
vxj -> oqr
vxk -> tnf
vxl -> iqc
vxm -> yag
vxn -> ufu
vxo -> hlb
vxp -> hob
vxq -> nxe
vxr -> hpa
vxs -> kbt
vxt -> wbp
vxu -> pky
vxv -> lvd
vxw -> okt
vxx -> rmq
vxy -> grb
vxz -> vqd
vya -> kdp
vyb -> deo
vyc -> kts
vyd -> wny
vye -> avh
vyf -> pqe
vyg -> ldp
vyh -> ayv
vyi -> utg
vyj -> uxj
vyk -> rkd
vyl -> jgu
vym -> wxb
vyn -> mvb
vyo -> xce
vyp -> tva
vyq -> fiy
vyr -> xna
vys -> umu
vyt -> osf
vyu -> zuv
vyv -> pzg
vyw -> ajn
vyx -> bip
vyy -> oqm
vyz -> uyg
vza -> zch
vzb -> rbf
vzc -> iam
vzd -> zco
vze -> xaz
vzf -> odg
vzg -> hwv
vzh -> gip
vzi -> tty
vzj -> jrx
vzk -> jvu
vzl -> isy
vzm -> tdo
vzn -> noc
vzo -> jym
vzp -> rbr
vzq -> vvj
vzr -> sqf
vzs -> tsk
vzt -> kvt
vzu -> vto
vzv -> dpw
vzw -> jhu
vzx -> pbc
vzy -> mfi
vzz -> yys
waa -> fja
wab -> tmq
wac -> kqc
wad -> bxm
wae -> oij
waf -> duf
wag -> tfy
wah -> ami
wai -> muu
waj -> eeu
wak -> iiq
wal -> zbx
wam -> lbr
wan -> izx
wao -> trf
wap -> qsy
waq -> iom
war -> tea
was -> xrg
wat -> zkk
wau -> erk
wav -> zhm
waw -> jck
wax -> jnl
way -> bwt
waz -> ptu
wba -> jle
wbb -> aok
wbc -> wsp
wbd -> fus
wbe -> mda
wbf -> wrp
wbg -> igl
wbh -> ekk
wbi -> nlc
wbj -> cvj
wbk -> rut
wbl -> cmu
wbm -> fny
wbn -> hhu
wbo -> cum
wbp -> rto
wbq -> bwh
wbr -> ptg
wbs -> daq
wbt -> fvu
wbu -> lyn
wbv -> jfg
wbw -> ieu
wbx -> dmg
wby -> eub
wbz -> uxy
wca -> jsq
wcb -> qhy
wcc -> cvu
wcd -> ejl
wce -> jeg
wcf -> txf
wcg -> hdh
wch -> icy
wci -> gdy
wcj -> lrc
wck -> mlt
wcl -> bas
wcm -> vgo
wcn -> ocp
wco -> fke
wcp -> wkj
wcq -> bbe
wcr -> kol
wcs -> rwr
wct -> xns
wcu -> obl
wcv -> vvg
wcw -> hhx
wcx -> xpe
wcy -> apu
wcz -> sgi
wda -> ycb
wdb -> msv
wdc -> qsw
wdd -> asc
wde -> nuu
wdf -> cpz
wdg -> fkv
wdh -> cge
wdi -> ezh
wdj -> zel
wdk -> knd
wdl -> lsl
wdm -> ksz
wdn -> mxk
wdo -> oqo
wdp -> ucf
wdq -> mqp
wdr -> pni
wds -> ewo
wdt -> dlg
wdu -> lib
wdv -> hog
wdw -> yix
wdx -> nkf
wdy -> qun
wdz -> sbr
wea -> iap
web -> cap
wec -> qew
wed -> bsq
wee -> vpt
wef -> fll
weg -> mga
weh -> wko
wei -> onu
wej -> kjo
wek -> vjr
wel -> ykh
wem -> gxp
wen -> qua
weo -> zlm
wep -> ohw
weq -> sdu
wer -> nqk
wes -> kco
wet -> xsv
weu -> lvo
wev -> qft
wew -> bja
wex -> hzi
wey -> rxz
wez -> moy
wfa -> jit
wfb -> nlz
wfc -> ylg
wfd -> frt
wfe -> pop
wff -> ynv
wfg -> psr
wfh -> gls
wfi -> gpm
wfj -> mkt
wfk -> jpk
wfl -> xcs
wfm -> ldw
wfn -> typ
wfo -> sqq
wfp -> wqr
wfq -> yaf
wfr -> mrl
wfs -> ngi
wft -> mdw
wfu -> zdo
wfv -> ish
wfw -> xsp
wfx -> bae
wfy -> pgz
wfz -> qxp
wga -> bmd
wgb -> qfe
wgc -> ooc
wgd -> zbi
wge -> mhj
wgf -> lzz
wgg -> oer
wgh -> pqs
wgi -> xtm
wgj -> dsl
wgk -> qia
wgl -> rrf
wgm -> qig
wgn -> cbp
wgo -> ayl
wgp -> bjb
wgq -> rbg
wgr -> wyh
wgs -> rpt
wgt -> mqf
wgu -> jjv
wgv -> fmb
wgw -> bok
wgx -> dsq
wgy -> hzl
wgz -> jer
wha -> ylh
whb -> all
whc -> rff
whd -> zyh
whe -> mxs
whf -> oes
whg -> ayw
whh -> ifo
whi -> aqn
whj -> tsc
whk -> nob
whl -> mvs
whm -> ntw
whn -> tfo
who -> dwq
whp -> ekh
whq -> gag
whr -> hto
whs -> hei
wht -> xnb
whu -> epy
whv -> wyu
whw -> sek
whx -> vbv
why -> csr
whz -> jvn
wia -> qjm
wib -> muc
wic -> ydx
wid -> vfl
wie -> wic
wif -> vcg
wig -> ius
wih -> dnx
wii -> krf
wij -> zei
wik -> ble
wil -> zim
wim -> dzd
win -> uzg
wio -> led
wip -> dte
wiq -> agb
wir -> dsm
wis -> bgb
wit -> eto
wiu -> fjr
wiv -> qyh
wiw -> uhq
wix -> jfu
wiy -> ohu
wiz -> ftn
wja -> ijb
wjb -> toi
wjc -> tau
wjd -> qty
wje -> aei
wjf -> flx
wjg -> gqm
wjh -> klw
wji -> pox
wjj -> udh
wjk -> pdz
wjl -> cgr
wjm -> blw
wjn -> xnc
wjo -> pvx
wjp -> myx
wjq -> ehp
wjr -> omf
wjs -> erv
wjt -> meo
wju -> hrx
wjv -> nuc
wjw -> tec
wjx -> dlt
wjy -> dwn
wjz -> hgm
wka -> gza
wkb -> lns
wkc -> jtn
wkd -> hgl
wke -> min
wkf -> ker
wkg -> lod
wkh -> gof
wki -> qen
wkj -> mde
wkk -> hzy
wkl -> gic
wkm -> ody
wkn -> quu
wko -> pkt
wkp -> qvv
wkq -> kkf
wkr -> wmi
wks -> efi
wkt -> wkc
wku -> hyz
wkv -> utk
wkw -> iok
wkx -> eyf
wky -> yyv
wkz -> dol
wla -> yhd
wlb -> ltr
wlc -> xbv
wld -> kqx
wle -> sor
wlf -> oxy
wlg -> clm
wlh -> yxv
wli -> rzd
wlj -> kvu
wlk -> wsv
wll -> mbz
wlm -> hfy
wln -> fge
wlo -> euk
wlp -> uwy
wlq -> hgg
wlr -> ksq
wls -> lvq
wlt -> xlx
wlu -> jsw
wlv -> hbe
wlw -> gin
wlx -> qkw
wly -> wqn
wlz -> pva
wma -> yvf
wmb -> tmc
wmc -> che
wmd -> hcg
wme -> lkl
wmf -> zid
wmg -> ceo
wmh -> slo
wmi -> vyr
wmj -> vmf
wmk -> szw
wml -> eot
wmm -> tdb
wmn -> fad
wmo -> wvv
wmp -> bpz
wmq -> hkm
wmr -> iuv
wms -> awv
wmt -> cre
wmu -> kef
wmv -> etk
wmw -> cyk
wmx -> tai
wmy -> pdp
wmz -> qcq
wna -> vrf
wnb -> rwx
wnc -> yca
wnd -> cwp
wne -> tzf
wnf -> alb
wng -> mrg
wnh -> wqu
wni -> phj
wnj -> xmo
wnk -> dvz
wnl -> eie
wnm -> uzk
wnn -> qht
wno -> vrq
wnp -> dxs
wnq -> vew
wnr -> ktb
wns -> ces
wnt -> nag
wnu -> ykg
wnv -> fmf
wnw -> slf
wnx -> gid
wny -> thz
wnz -> iha
woa -> sma
wob -> ybe
woc -> phy
wod -> ktq
woe -> gjx
wof -> srg
wog -> cbj
woh -> neu
woi -> prq
woj -> gdx
wok -> qoa
wol -> ncj
wom -> pkb
won -> ovn
woo -> hag
wop -> esq
woq -> ozh
wor -> fxj
wos -> qvl
wot -> diq
wou -> quj
wov -> cym
wow -> ycv
wox -> mdt
woy -> pxw
woz -> pnf
wpa -> myk
wpb -> rwl
wpc -> ari
wpd -> nap
wpe -> lkm
wpf -> tld
wpg -> vhd
wph -> qyr
wpi -> yng
wpj -> qgb
wpk -> ync
wpl -> rjw
wpm -> cia
wpn -> rwg
wpo -> lyw
wpp -> emt
wpq -> acs
wpr -> wcx
wps -> fsr
wpt -> ggt
wpu -> oht
wpv -> svd
wpw -> vyq
wpx -> vxi
wpy -> nus
wpz -> wyd
wqa -> ygq
wqb -> hrd
wqc -> cbh
wqd -> nzl
wqe -> nzw
wqf -> fsw
wqg -> nlq
wqh -> don
wqi -> gyg
wqj -> iuz
wqk -> hwc
wql -> vjx
wqm -> hoq
wqn -> ggx
wqo -> ewy
wqp -> ffc
wqq -> phk
wqr -> yit
wqs -> jjj
wqt -> zqp
wqu -> bsi
wqv -> cvn
wqw -> uco
wqx -> wrf
wqy -> afz
wqz -> uuw
wra -> tjd
wrb -> bsz
wrc -> rib
wrd -> diw
wre -> ytq
wrf -> ogx
wrg -> bii
wrh -> dad
wri -> bce
wrj -> tmn
wrk -> vre
wrl -> hru
wrm -> xmk
wrn -> xya
wro -> six
wrp -> rez
wrq -> dty
wrr -> syh
wrs -> epz
wrt -> szt
wru -> ess
wrv -> fjz
wrw -> uxh
wrx -> jyz
wry -> msp
wrz -> rsv
wsa -> wud
wsb -> tyw
wsc -> emv
wsd -> ulm
wse -> qxx
wsf -> fbm
wsg -> qxq
wsh -> gir
wsi -> bcx
wsj -> huj
wsk -> brv
wsl -> zne
wsm -> afh
wsn -> mkw
wso -> xox
wsp -> mvv
wsq -> zud
wsr -> ewg
wss -> gge
wst -> dyf
wsu -> cyz
wsv -> cub
wsw -> qdk
wsx -> hjg
wsy -> wrt
wsz -> jww
wta -> gos
wtb -> sji
wtc -> zjs
wtd -> lwz
wte -> zgh
wtf -> tpk
wtg -> wqm
wth -> ran
wti -> xwr
wtj -> qfq
wtk -> icj
wtl -> kke
wtm -> egn
wtn -> nds
wto -> ikw
wtp -> tnb
wtq -> coo
wtr -> mtl
wts -> hpq
wtt -> rxf
wtu -> xfd
wtv -> rkv
wtw -> uws
wtx -> adl
wty -> xyu
wtz -> clj
wua -> qsa
wub -> nxs
wuc -> dmp
wud -> gtu
wue -> ihn
wuf -> mpc
wug -> qqk
wuh -> ebl
wui -> txl
wuj -> ycx
wuk -> ixy
wul -> oqc
wum -> ayb
wun -> oen
wuo -> ctm
wup -> ggv
wuq -> uvf
wur -> wav
wus -> tkh
wut -> ehr
wuu -> qnw
wuv -> gze
wuw -> zhi
wux -> hcc
wuy -> tsb
wuz -> hyn
wva -> sfg
wvb -> hkn
wvc -> xvc
wvd -> uyy
wve -> ggc
wvf -> pxi
wvg -> sur
wvh -> pmj
wvi -> sku
wvj -> uyq
wvk -> ecw
wvl -> mhg
wvm -> wwz
wvn -> sjz
wvo -> oth
wvp -> oqv
wvq -> jqf
wvr -> sqs
wvs -> vab
wvt -> sub
wvu -> jzn
wvv -> stb
wvw -> ezi
wvx -> tus
wvy -> zmg
wvz -> flu
wwa -> rda
wwb -> blz
wwc -> ikh
wwd -> aoy
wwe -> jbr
wwf -> qsg
wwg -> gbh
wwh -> lrf
wwi -> yvv
wwj -> atd
wwk -> gmf
wwl -> ssw
wwm -> qlr
wwn -> iqm
wwo -> nqd
wwp -> kxt
wwq -> uhm
wwr -> xxo
wws -> muh
wwt -> qpk
wwu -> ick
wwv -> dqe
www -> zeb
wwx -> xyr
wwy -> mjf
wwz -> aik
wxa -> die
wxb -> pmz
wxc -> tem
wxd -> qop
wxe -> ijk
wxf -> jxh
wxg -> nlu
wxh -> kzn
wxi -> qtf
wxj -> koz
wxk -> dqv
wxl -> yyu
wxm -> ghp
wxn -> gog
wxo -> umc
wxp -> jns
wxq -> hzn
wxr -> qul
wxs -> kjc
wxt -> wrw
wxu -> sox
wxv -> pph
wxw -> pht
wxx -> qsp
wxy -> zdy
wxz -> izm
wya -> zod
wyb -> qtd
wyc -> kwx
wyd -> hzu
wye -> hgj
wyf -> tfa
wyg -> tyb
wyh -> grt
wyi -> qeb
wyj -> mzb
wyk -> hsq
wyl -> xdb
wym -> xne
wyn -> sds
wyo -> ogo
wyp -> ydd
wyq -> kmr
wyr -> mgt
wys -> qpi
wyt -> ekg
wyu -> sxy
wyv -> kci
wyw -> joh
wyx -> qep
wyy -> nbj
wyz -> anp
wza -> ktd
wzb -> lgp
wzc -> ywp
wzd -> mdr
wze -> tbx
wzf -> zpb
wzg -> kwa
wzh -> uyr
wzi -> xnk
wzj -> soc
wzk -> aag
wzl -> dnz
wzm -> xyn
wzn -> fzq
wzo -> iyr
wzp -> gdh
wzq -> mdb
wzr -> gpb
wzs -> bji
wzt -> cqj
wzu -> iwy
wzv -> kne
wzw -> ufi
wzx -> rlv
wzy -> lgm
wzz -> fps
xaa -> dui
xab -> kzo
xac -> uua
xad -> ned
xae -> bxn
xaf -> dgq
xag -> fcd
xah -> ytb
xai -> nex
xaj -> ycp
xak -> zpt
xal -> rsu
xam -> xue
xan -> yff
xao -> shr
xap -> kou
xaq -> ebp
xar -> lyk
xas -> jae
xat -> ket
xau -> uln
xav -> lzx
xaw -> vyh
xax -> wfn
xay -> qck
xaz -> cul
xba -> tzn
xbb -> sfo
xbc -> nsw
xbd -> iww
xbe -> yst
xbf -> xvj
xbg -> ivc
xbh -> upf
xbi -> ggh
xbj -> ane
xbk -> wbe
xbl -> nmz
xbm -> pch
xbn -> aoc
xbo -> pis
xbp -> rhz
xbq -> zwk
xbr -> ixe
xbs -> bdc
xbt -> bdb
xbu -> zxg
xbv -> wid
xbw -> pvf
xbx -> kze
xby -> bre
xbz -> bsa
xca -> djd
xcb -> bfb
xcc -> dfv
xcd -> rsn
xce -> nlj
xcf -> btf
xcg -> eyk
xch -> xwx
xci -> dcp
xcj -> zzy
xck -> vhh
xcl -> jhy
xcm -> dck
xcn -> iwc
xco -> haq
xcp -> lch
xcq -> amt
xcr -> caq
xcs -> cdd
xct -> mxj
xcu -> ery
xcv -> piy
xcw -> xbq
xcx -> hvu
xcy -> zfv
xcz -> vsf
xda -> sjs
xdb -> ohk
xdc -> yoy
xdd -> mys
xde -> hrf
xdf -> tqb
xdg -> con
xdh -> bvw
xdi -> dgw
xdj -> eud
xdk -> lrh
xdl -> ixq
xdm -> hab
xdn -> sdc
xdo -> dsf
xdp -> eyg
xdq -> ppw
xdr -> tzm
xds -> qgp
xdt -> apd
xdu -> kdo
xdv -> qbx
xdw -> oae
xdx -> uuq
xdy -> aht
xdz -> mps
xea -> cfq
xeb -> sal
xec -> ofu
xed -> gye
xee -> pkx
xef -> wzk
xeg -> qhf
xeh -> eln
xei -> bgh
xej -> ydo
xek -> tfp
xel -> uay
xem -> qwi
xen -> ngz
xeo -> wod
xep -> mll
xeq -> wxc
xer -> fhq
xes -> fks
xet -> lkq
xeu -> kpr
xev -> loc
xew -> ypd
xex -> owo
xey -> poa
xez -> svj
xfa -> hpe
xfb -> nef
xfc -> lhm
xfd -> fzb
xfe -> ygd
xff -> ugp
xfg -> yty
xfh -> gzx
xfi -> pgs
xfj -> jgy
xfk -> npr
xfl -> gkq
xfm -> mlj
xfn -> ebn
xfo -> ecy
xfp -> age
xfq -> cqm
xfr -> zli
xfs -> scx
xft -> ibw
xfu -> cea
xfv -> mhy
xfw -> fzg
xfx -> wwv
xfy -> zly
xfz -> jjz
xga -> cur
xgb -> yil
xgc -> wdp
xgd -> eww
xge -> yeg
xgf -> sgf
xgg -> bgj
xgh -> upv
xgi -> uny
xgj -> tfb
xgk -> fto
xgl -> zkv
xgm -> qqm
xgn -> jjn
xgo -> pmv
xgp -> uvk
xgq -> nqq
xgr -> wue
xgs -> gal
xgt -> srx
xgu -> jgt
xgv -> ogs
xgw -> crx
xgx -> edz
xgy -> mkx
xgz -> gjt
xha -> wqy
xhb -> zcr
xhc -> zge
xhd -> bfl
xhe -> arc
xhf -> dni
xhg -> jyi
xhh -> bzq
xhi -> ibv
xhj -> ysw
xhk -> xpg
xhl -> evp
xhm -> qrj
xhn -> zmj
xho -> bbr
xhp -> usj
xhq -> ysl
xhr -> tak
xhs -> gvo
xht -> xtz
xhu -> sxu
xhv -> jih
xhw -> btr
xhx -> qlg
xhy -> ncd
xhz -> pqr
xia -> vvh
xib -> dth
xic -> lqp
xid -> dbw
xie -> mxc
xif -> usv
xig -> lie
xih -> pjn
xii -> bbi
xij -> nsr
xik -> dhl
xil -> orl
xim -> pxr
xin -> vwm
xio -> amw
xip -> oug
xiq -> qtn
xir -> dld
xis -> der
xit -> qow
xiu -> bak
xiv -> evb
xiw -> ikq
xix -> smy
xiy -> hay
xiz -> spk
xja -> jes
xjb -> yha
xjc -> ypl
xjd -> ufq
xje -> taj
xjf -> pmc
xjg -> szk
xjh -> lbg
xji -> ndr
xjj -> zam
xjk -> auu
xjl -> adg
xjm -> tyn
xjn -> scy
xjo -> bcz
xjp -> mob
xjq -> qeo
xjr -> trv
xjs -> ram
xjt -> bgq
xju -> pae
xjv -> qjx
xjw -> tvd
xjx -> htu
xjy -> nto
xjz -> acx
xka -> oul
xkb -> qwk
xkc -> pcw
xkd -> ieq
xke -> byo
xkf -> pdw
xkg -> maq
xkh -> obb
xki -> wbs
xkj -> zfz
xkk -> mwn
xkl -> uqq
xkm -> rln
xkn -> bbh
xko -> mhl
xkp -> okz
xkq -> tmv
xkr -> eze
xks -> xis
xkt -> vlx
xku -> lya
xkv -> get
xkw -> lzq
xkx -> wbb
xky -> elf
xkz -> sye
xla -> ryg
xlb -> pyv
xlc -> oii
xld -> bzk
xle -> ncw
xlf -> gmy
xlg -> brq
xlh -> ubl
xli -> rfh
xlj -> edl
xlk -> mfq
xll -> yjq
xlm -> zkr
xln -> llp
xlo -> eao
xlp -> tqj
xlq -> faf
xlr -> jor
xls -> non
xlt -> vkx
xlu -> wph
xlv -> tvh
xlw -> whu
xlx -> vua
xly -> cqk
xlz -> nro
xma -> fns
xmb -> mmh
xmc -> kij
xmd -> nqb
xme -> icd
xmf -> ohy
xmg -> oay
xmh -> yxd
xmi -> ujf
xmj -> gox
xmk -> cwx
xml -> isa
xmm -> ebk
xmn -> dak
xmo -> pcb
xmp -> ngm
xmq -> mmc
xmr -> rux
xms -> unw
xmt -> jof
xmu -> xml
xmv -> ckt
xmw -> ozq
xmx -> wem
xmy -> pbk
xmz -> zrp
xna -> ekv
xnb -> enk
xnc -> kzr
xnd -> tfz
xne -> chm
xnf -> sbd
xng -> orn
xnh -> bva
xni -> klm
xnj -> foc
xnk -> ksp
xnl -> rqz
xnm -> fgt
xnn -> zis
xno -> dfd
xnp -> nrg
xnq -> veg
xnr -> sxb
xns -> yyw
xnt -> dbs
xnu -> byu
xnv -> gnl
xnw -> ilp
xnx -> kqy
xny -> shz
xnz -> nxx
xoa -> sxn
xob -> ldf
xoc -> uit
xod -> khe
xoe -> aef
xof -> zep
xog -> sbg
xoh -> dep
xoi -> ycc
xoj -> aiv
xok -> yqb
xol -> drd
xom -> ynz
xon -> pin
xoo -> uib
xop -> xhb
xoq -> njk
xor -> llk
xos -> tex
xot -> bbw
xou -> oew
xov -> tox
xow -> whp
xox -> xtw
xoy -> lfu
xoz -> ywc
xpa -> wuu
xpb -> akx
xpc -> ziv
xpd -> rrk
xpe -> num
xpf -> odi
xpg -> gft
xph -> xdk
xpi -> vxx
xpj -> vlk
xpk -> nyl
xpl -> spp
xpm -> iwm
xpn -> ppk
xpo -> jcp
xpp -> hiy
xpq -> hgf
xpr -> oof
xps -> gqs
xpt -> pma
xpu -> exw
xpv -> vol
xpw -> ztu
xpx -> fer
xpy -> kcc
xpz -> xpo
xqa -> xwl
xqb -> yku
xqc -> yzh
xqd -> xzu
xqe -> wdh
xqf -> eoj
xqg -> kyv
xqh -> cxm
xqi -> kbb
xqj -> krm
xqk -> tcq
xql -> qru
xqm -> lvk
xqn -> zcm
xqo -> ucj
xqp -> yvh
xqq -> alc
xqr -> pcz
xqs -> rze
xqt -> xao
xqu -> slg
xqv -> nng
xqw -> cdi
xqx -> qsf
xqy -> myl
xqz -> cjd
xra -> wvi
xrb -> qyw
xrc -> oqn
xrd -> twe
xre -> iye
xrf -> ngp
xrg -> lxo
xrh -> krw
xri -> wgb
xrj -> rse
xrk -> oga
xrl -> nll
xrm -> zag
xrn -> gvx
xro -> fpy
xrp -> mic
xrq -> duo
xrr -> uzx
xrs -> ygc
xrt -> sfr
xru -> bxv
xrv -> rnj
xrw -> pfp
xrx -> yxr
xry -> akz
xrz -> tqq
xsa -> qsk
xsb -> mpi
xsc -> yvx
xsd -> juq
xse -> hwl
xsf -> rhj
xsg -> wlq
xsh -> rlc
xsi -> ryk
xsj -> dok
xsk -> guo
xsl -> tzq
xsm -> bzg
xsn -> jdx
xso -> zgo
xsp -> rcw
xsq -> nie
xsr -> omh
xss -> nls
xst -> guy
xsu -> kdf
xsv -> rqq
xsw -> xgo
xsx -> wgl
xsy -> lzb
xsz -> omo
xta -> zif
xtb -> oqt
xtc -> slp
xtd -> tnt
xte -> ttn
xtf -> otw
xtg -> rub
xth -> lor
xti -> kgc
xtj -> ovb
xtk -> etw
xtl -> jkq
xtm -> vqe
xtn -> tkr
xto -> ttt
xtp -> wkm
xtq -> tum
xtr -> bqy
xts -> byn
xtt -> was
xtu -> voc
xtv -> nht
xtw -> rmc
xtx -> jok
xty -> fgx
xtz -> dee
xua -> qnm
xub -> mdd
xuc -> cce
xud -> yrv
xue -> mvy
xuf -> cav
xug -> wpp
xuh -> oez
xui -> kvn
xuj -> ynu
xuk -> mvi
xul -> prz
xum -> rkz
xun -> htd
xuo -> qkf
xup -> rsm
xuq -> ktj
xur -> pjl
xus -> bkb
xut -> qaw
xuu -> qnv
xuv -> ydw
xuw -> pqt
xux -> nre
xuy -> rfj
xuz -> lij
xva -> czk
xvb -> jdq
xvc -> jkz
xvd -> fqi
xve -> pyi
xvf -> zpm
xvg -> iht
xvh -> tji
xvi -> ixp
xvj -> mio
xvk -> jye
xvl -> rtb
xvm -> ofr
xvn -> xyt
xvo -> lps
xvp -> jll
xvq -> ukz
xvr -> dzf
xvs -> myi
xvt -> mzw
xvu -> cox
xvv -> vwe
xvw -> wma
xvx -> tqr
xvy -> vaw
xvz -> dfj
xwa -> jlc
xwb -> rnc
xwc -> lha
xwd -> gtd
xwe -> abr
xwf -> vms
xwg -> mmd
xwh -> mnk
xwi -> gyk
xwj -> kew
xwk -> awj
xwl -> ien
xwm -> bij
xwn -> pvi
xwo -> vcf
xwp -> uax
xwq -> asv
xwr -> phm
xws -> mxf
xwt -> yws
xwu -> zxf
xwv -> zgv
xww -> bum
xwx -> sxs
xwy -> ljq
xwz -> uir
xxa -> sih
xxb -> vxv
xxc -> qyj
xxd -> eeg
xxe -> cff
xxf -> yij
xxg -> vad
xxh -> svp
xxi -> yeu
xxj -> hus
xxk -> itz
xxl -> rjh
xxm -> sqc
xxn -> ejg
xxo -> xap
xxp -> ynk
xxq -> sdt
xxr -> slj
xxs -> qex
xxt -> yrk
xxu -> gax
xxv -> jaj
xxw -> etg
xxx -> ysc
xxy -> qsu
xxz -> unm
xya -> acn
xyb -> ylx
xyc -> hmp
xyd -> ijd
xye -> ooh
xyf -> yml
xyg -> nip
xyh -> tko
xyi -> tyd
xyj -> hcv
xyk -> idb
xyl -> nii
xym -> fmm
xyn -> ojy
xyo -> xbf
xyp -> dgh
xyq -> idd
xyr -> awq
xys -> fvo
xyt -> kio
xyu -> sgk
xyv -> jmu
xyw -> omk
xyx -> rur
xyy -> qmv
xyz -> tzz
xza -> ulh
xzb -> tvi
xzc -> ldv
xzd -> jaa
xze -> cdt
xzf -> uox
xzg -> jba
xzh -> mec
xzi -> aza
xzj -> iov
xzk -> jft
xzl -> vcm
xzm -> iij
xzn -> jqj
xzo -> vqn
xzp -> tyt
xzq -> thd
xzr -> xgq
xzs -> dyg
xzt -> pdo
xzu -> rmn
xzv -> drk
xzw -> plg
xzx -> rvl
xzy -> qfj
xzz -> goa
yaa -> vrr
yab -> blp
yac -> nnm
yad -> qyx
yae -> erb
yaf -> qou
yag -> rae
yah -> mpp
yai -> qlz
yaj -> efe
yak -> bnc
yal -> qgm
yam -> wcz
yan -> ecr
yao -> cxe
yap -> zdi
yaq -> juc
yar -> orc
yas -> aah
yat -> ljm
yau -> ihr
yav -> inb
yaw -> kmp
yax -> bgn
yay -> qqj
yaz -> uos
yba -> zvn
ybb -> lhf
ybc -> bfs
ybd -> tgu
ybe -> npn
ybf -> dgf
ybg -> vmz
ybh -> zpe
ybi -> vqa
ybj -> rdi
ybk -> ynw
ybl -> ifp
ybm -> nth
ybn -> xeg
ybo -> rik
ybp -> lsj
ybq -> zgl
ybr -> tac
ybs -> zlv
ybt -> xky
ybu -> nfu
ybv -> kua
ybw -> bze
ybx -> ixj
yby -> qjj
ybz -> sml
yca -> xyb
ycb -> ksl
ycc -> eyy
ycd -> hjr
yce -> shi
ycf -> owb
ycg -> qwq
ych -> oye
yci -> adf
ycj -> chk
yck -> kvi
ycl -> hfm
ycm -> yya
ycn -> rja
yco -> tuz
ycp -> fum
ycq -> etb
ycr -> mmu
ycs -> wai
yct -> ugl
ycu -> cpi
ycv -> vzu
ycw -> pcl
ycx -> scj
ycy -> sen
ycz -> gei
yda -> qei
ydb -> cst
ydc -> pld
ydd -> tqx
yde -> qin
ydf -> bhq
ydg -> ojj
ydh -> rrt
ydi -> din
ydj -> yyf
ydk -> uld
ydl -> pgk
ydm -> rqa
ydn -> sdh
ydo -> ine
ydp -> tvt
ydq -> tbv
ydr -> xun
yds -> pwh
ydt -> hgh
ydu -> dvy
ydv -> bpm
ydw -> vej
ydx -> msi
ydy -> hgx
ydz -> bxh
yea -> lhg
yeb -> lck
yec -> aeh
yed -> zht
yee -> bgu
yef -> gns
yeg -> qrf
yeh -> fgw
yei -> pge
yej -> wis
yek -> vvz
yel -> rfy
yem -> vqy
yen -> xxr
yeo -> ndp
yep -> dkp
yeq -> cle
yer -> xbw
yes -> zan
yet -> fbs
yeu -> yhx
yev -> ves
yew -> kpn
yex -> cxh
yey -> fsk
yez -> kgq
yfa -> jcx
yfb -> yrh
yfc -> ddl
yfd -> pxl
yfe -> vrg
yff -> vdt
yfg -> kdb
yfh -> dcm
yfi -> odf
yfj -> vam
yfk -> muf
yfl -> nps
yfm -> ekc
yfn -> meg
yfo -> rvr
yfp -> ulj
yfq -> rcu
yfr -> kic
yfs -> rxv
yft -> xll
yfu -> yvl
yfv -> cdg
yfw -> uth
yfx -> nnb
yfy -> gjq
yfz -> eyl
yga -> vzt
ygb -> efa
ygc -> bjp
ygd -> rce
yge -> prm
ygf -> ncm
ygg -> qeq
ygh -> dnq
ygi -> yau
ygj -> bpg
ygk -> wwj
ygl -> pxq
ygm -> app
ygn -> yql
ygo -> rjk
ygp -> csh
ygq -> jvl
ygr -> ezn
ygs -> xjo
ygt -> awr
ygu -> sfi
ygv -> yay
ygw -> vvk
ygx -> dxx
ygy -> rvc
ygz -> jzs
yha -> qwx
yhb -> fyn
yhc -> rzb
yhd -> ecd
yhe -> llz
yhf -> ajx
yhg -> hck
yhh -> pfk
yhi -> bvg
yhj -> uut
yhk -> mvx
yhl -> zov
yhm -> vdh
yhn -> ncc
yho -> izq
yhp -> dbf
yhq -> phf
yhr -> jko
yhs -> mck
yht -> sqb
yhu -> kah
yhv -> nrr
yhw -> onz
yhx -> nts
yhy -> eat
yhz -> yeo
yia -> dff
yib -> alm
yic -> sls
yid -> yew
yie -> hsk
yif -> sbo
yig -> evl
yih -> fku
yii -> mxh
yij -> uqp
yik -> oee
yil -> tot
yim -> xyi
yin -> azb
yio -> afl
yip -> fbn
yiq -> jxn
yir -> qqn
yis -> wiv
yit -> ufz
yiu -> vpw
yiv -> vwi
yiw -> zzw
yix -> ocr
yiy -> kpa
yiz -> pip
yja -> zql
yjb -> cuq
yjc -> wso
yjd -> nko
yje -> mmm
yjf -> nqg
yjg -> akd
yjh -> jvs
yji -> jej
yjj -> ewc
yjk -> eqd
yjl -> ykf
yjm -> orx
yjn -> tbg
yjo -> hlh
yjp -> ccb
yjq -> aps
yjr -> zgq
yjs -> arm
yjt -> vaq
yju -> ecz
yjv -> phz
yjw -> hqn
yjx -> fsg
yjy -> lfx
yjz -> xyq
yka -> iwx
ykb -> xww
ykc -> usr
ykd -> jyx
yke -> ctl
ykf -> omd
ykg -> rfg
ykh -> ogk
yki -> zuy
ykj -> spl
ykk -> ols
ykl -> pnb
ykm -> dxp
ykn -> kxl
yko -> epl
ykp -> kap
ykq -> ior
ykr -> wta
yks -> dvk
ykt -> ynx
yku -> xop
ykv -> kej
ykw -> wqe
ykx -> cms
yky -> jyw
ykz -> bti
yla -> jje
ylb -> eia
ylc -> wtc
yld -> mjk
yle -> elh
ylf -> ovw
ylg -> cmj
ylh -> rxi
yli -> dbo
ylj -> fiv
ylk -> xer
yll -> coz
ylm -> dop
yln -> dkj
ylo -> kyw
ylp -> pmd
ylq -> fdi
ylr -> aos
yls -> lul
ylt -> vlb
ylu -> cds
ylv -> hxs
ylw -> kbc
ylx -> fxt
yly -> lcb
ylz -> scb
yma -> grp
ymb -> est
ymc -> dsa
ymd -> lla
yme -> ful
ymf -> eab
ymg -> mik
ymh -> nyv
ymi -> oys
ymj -> dgs
ymk -> gop
yml -> qbr
ymm -> azw
ymn -> ixz
ymo -> rfc
ymp -> dpj
ymq -> nbd
ymr -> azj
yms -> wyy
ymt -> vom
ymu -> ywj
ymv -> iyz
ymw -> loq
ymx -> svs
ymy -> fff
ymz -> mlh
yna -> tht
ynb -> eil
ync -> fgp
ynd -> ezk
yne -> sdl
ynf -> ftq
yng -> qkm
ynh -> foh
yni -> wzq
ynj -> djq
ynk -> jey
ynl -> yus
ynm -> ddo
ynn -> qed
yno -> vvc
ynp -> hvh
ynq -> wgp
ynr -> jfa
yns -> iow
ynt -> ahi
ynu -> jwe
ynv -> nhj
ynw -> dzb
ynx -> cyl
yny -> cep
ynz -> qhd
yoa -> gmq
yob -> qwr
yoc -> fhs
yod -> eod
yoe -> inz
yof -> lbm
yog -> hwn
yoh -> cml
yoi -> ooy
yoj -> mzg
yok -> sdi
yol -> ikg
yom -> lpn
yon -> ghe
yoo -> zxu
yop -> osl
yoq -> kod
yor -> pmw
yos -> dar
yot -> ina
you -> xfx
yov -> tos
yow -> ybg
yox -> wbg
yoy -> krq
yoz -> xhv
ypa -> pkr
ypb -> kpo
ypc -> zgj
ypd -> iwq
ype -> wba
ypf -> yqw
ypg -> uqr
yph -> jpu
ypi -> yhv
ypj -> ioc
ypk -> rok
ypl -> gcg
ypm -> bnu
ypn -> bfk
ypo -> rvj
ypp -> qfw
ypq -> cwk
ypr -> etz
yps -> eck
ypt -> cec
ypu -> szo
ypv -> vfw
ypw -> wvr
ypx -> ggz
ypy -> wij
ypz -> afx
yqa -> abm
yqb -> ruz
yqc -> lrk
yqd -> wms
yqe -> kwi
yqf -> uqk
yqg -> gao
yqh -> pqq
yqi -> aip
yqj -> wrm
yqk -> xaf
yql -> pze
yqm -> elq
yqn -> tnq
yqo -> faw
yqp -> qje
yqq -> aoa
yqr -> ubr
yqs -> yuz
yqt -> gmc
yqu -> xys
yqv -> hox
yqw -> fsb
yqx -> rqh
yqy -> mlv
yqz -> ouk
yra -> tif
yrb -> txm
yrc -> kwt
yrd -> zci
yre -> zmm
yrf -> wwo
yrg -> drn
yrh -> mvj
yri -> ugy
yrj -> gcm
yrk -> fgc
yrl -> gmk
yrm -> npe
yrn -> vwh
yro -> pam
yrp -> nyg
yrq -> dvh
yrr -> dup
yrs -> wwe
yrt -> juz
yru -> iwd
yrv -> gpz
yrw -> xol
yrx -> osi
yry -> bax
yrz -> kxr
ysa -> qux
ysb -> nid
ysc -> vuq
ysd -> lez
yse -> cnb
ysf -> oxt
ysg -> ywn
ysh -> qbu
ysi -> cun
ysj -> avp
ysk -> uxi
ysl -> mip
ysm -> awb
ysn -> uet
yso -> frb
ysp -> dml
ysq -> hel
ysr -> orm
yss -> pzp
yst -> lle
ysu -> dnp
ysv -> zgp
ysw -> eas
ysx -> eoy
ysy -> hsc
ysz -> dal
yta -> hwr
ytb -> jnu
ytc -> nkv
ytd -> tzl
yte -> jkf
ytf -> kwo
ytg -> ukh
yth -> dwt
yti -> kkm
ytj -> sdz
ytk -> bpj
ytl -> ikj
ytm -> fkn
ytn -> lfy
yto -> qax
ytp -> amr
ytq -> abv
ytr -> mcp
yts -> dwl
ytt -> zqx
ytu -> ibx
ytv -> lrr
ytw -> dqp
ytx -> doq
yty -> zok
ytz -> dqo
yua -> zuf
yub -> eby
yuc -> vbs
yud -> zrd
yue -> ydl
yuf -> dkk
yug -> oql
yuh -> wwl
yui -> rth
yuj -> xia
yuk -> flc
yul -> ylp
yum -> ckn
yun -> mct
yuo -> qxc
yup -> srm
yuq -> xdg
yur -> hzs
yus -> ufd
yut -> kjz
yuu -> tzb
yuv -> jys
yuw -> iph
yux -> epu
yuy -> zjt
yuz -> jlp
yva -> ndx
yvb -> ucl
yvc -> ajo
yvd -> vuf
yve -> jmr
yvf -> afn
yvg -> nvc
yvh -> egt
yvi -> ovj
yvj -> phc
yvk -> for
yvl -> gkt
yvm -> osn
yvn -> fhh
yvo -> plq
yvp -> sij
yvq -> ejv
yvr -> pvb
yvs -> bka
yvt -> agn
yvu -> oeu
yvv -> vwf
yvw -> ecp
yvx -> pxj
yvy -> mzm
yvz -> xpq
ywa -> hvd
ywb -> soj
ywc -> hwj
ywd -> gmd
ywe -> xif
ywf -> bgf
ywg -> nkj
ywh -> xjf
ywi -> yrp
ywj -> nfc
ywk -> mdv
ywl -> txx
ywm -> qsc
ywn -> kjn
ywo -> abg
ywp -> bjh
ywq -> evw
ywr -> lyr
yws -> glp
ywt -> var
ywu -> ufl
ywv -> taf
yww -> oxo
ywx -> swb
ywy -> jim
ywz -> wdr
yxa -> ake
yxb -> mzf
yxc -> dut
yxd -> xdf
yxe -> wzh
yxf -> grr
yxg -> zxy
yxh -> ftp
yxi -> fgj
yxj -> gnr
yxk -> lzk
yxl -> xgu
yxm -> mrz
yxn -> xtb
yxo -> ebd
yxp -> oqw
yxq -> dwu
yxr -> sqo
yxs -> jby
yxt -> alj
yxu -> wby
yxv -> cyt
yxw -> jtp
yxx -> pro
yxy -> doj
yxz -> yie
yya -> mit
yyb -> yyj
yyc -> uva
yyd -> lbl
yye -> ajk
yyf -> bwm
yyg -> rta
yyh -> qif
yyi -> yhf
yyj -> eoc
yyk -> neh
yyl -> blo
yym -> rlh
yyn -> fpb
yyo -> pnv
yyp -> pes
yyq -> ich
yyr -> smv
yys -> rjy
yyt -> iqp
yyu -> obd
yyv -> blm
yyw -> xjk
yyx -> yym
yyy -> ost
yyz -> drx
yza -> qzl
yzb -> wvg
yzc -> pmh
yzd -> cnj
yze -> sbi
yzf -> xxh
yzg -> ckh
yzh -> ata
yzi -> oqg
yzj -> oce
yzk -> prc
yzl -> mym
yzm -> kwv
yzn -> bex
yzo -> fig
yzp -> jig
yzq -> qta
yzr -> bbd
yzs -> meh
yzt -> eld
yzu -> ibu
yzv -> yom
yzw -> tui
yzx -> tvu
yzy -> bps
yzz -> rdh
zaa -> rfr
zab -> axb
zac -> nxn
zad -> lsu
zae -> scw
zaf -> acl
zag -> lzj
zah -> sps
zai -> rma
zaj -> fpf
zak -> abz
zal -> kam
zam -> vwr
zan -> xlh
zao -> xle
zap -> odd
zaq -> sbb
zar -> iqu
zas -> rzy
zat -> gds
zau -> pvn
zav -> lua
zaw -> rpr
zax -> rpv
zay -> lyy
zaz -> why
zba -> hvk
zbb -> wlt
zbc -> pnz
zbd -> iiz
zbe -> xrn
zbf -> xso
zbg -> mqv
zbh -> xti
zbi -> hqg
zbj -> uzj
zbk -> iga
zbl -> qas
zbm -> evk
zbn -> umt
zbo -> jjl
zbp -> cqg
zbq -> ioi
zbr -> kmm
zbs -> puz
zbt -> oeb
zbu -> jue
zbv -> bgg
zbw -> fem
zbx -> qwz
zby -> fcz
zbz -> nrv
zca -> ugk
zcb -> tom
zcc -> ejf
zcd -> lcu
zce -> izv
zcf -> dzq
zcg -> lpf
zch -> tuu
zci -> vcq
zcj -> yid
zck -> ydz
zcl -> wob
zcm -> yrq
zcn -> eha
zco -> slq
zcp -> zdw
zcq -> gqu
zcr -> xae
zcs -> cvf
zct -> vba
zcu -> lja
zcv -> zhw
zcw -> gqp
zcx -> mrq
zcy -> fir
zcz -> slm
zda -> eij
zdb -> tuh
zdc -> yae
zdd -> ngh
zde -> xks
zdf -> nbf
zdg -> adx
zdh -> fin
zdi -> ind
zdj -> mud
zdk -> fan
zdl -> uvn
zdm -> ibd
zdn -> gbv
zdo -> sqn
zdp -> lhr
zdq -> aff
zdr -> ncl
zds -> rzm
zdt -> asq
zdu -> rsq
zdv -> zvk
zdw -> ytz
zdx -> rpy
zdy -> qcj
zdz -> hbc
zea -> fzh
zeb -> ajb
zec -> zsf
zed -> ggd
zee -> eno
zef -> zcq
zeg -> lwh
zeh -> mmq
zei -> oqd
zej -> nyj
zek -> lgq
zel -> zvl
zem -> ouo
zen -> zzz
zeo -> mhh
zep -> cnp
zeq -> tvl
zer -> hjw
zes -> ffv
zet -> quk
zeu -> yrs
zev -> lyj
zew -> wqz
zex -> ahu
zey -> cgp
zez -> sgz
zfa -> iup
zfb -> ona
zfc -> ixh
zfd -> fhj
zfe -> vqr
zff -> cik
zfg -> vya
zfh -> npj
zfi -> yjl
zfj -> zhp
zfk -> fne
zfl -> muq
zfm -> uly
zfn -> zmr
zfo -> klt
zfp -> mbk
zfq -> juu
zfr -> zmo
zfs -> gst
zft -> oef
zfu -> aqe
zfv -> pgi
zfw -> pxt
zfx -> fsd
zfy -> qdn
zfz -> eqq
zga -> kdv
zgb -> dfm
zgc -> aun
zgd -> lfk
zge -> pmo
zgf -> dgr
zgg -> vnx
zgh -> nma
zgi -> kem
zgj -> sxi
zgk -> rou
zgl -> zai
zgm -> sul
zgn -> ret
zgo -> cfb
zgp -> fev
zgq -> lxu
zgr -> kcu
zgs -> iqa
zgt -> scs
zgu -> woo
zgv -> xni
zgw -> lrx
zgx -> bjf
zgy -> aex
zgz -> unp
zha -> cxt
zhb -> brt
zhc -> nhp
zhd -> elb
zhe -> rup
zhf -> koq
zhg -> klq
zhh -> kfa
zhi -> puw
zhj -> ejr
zhk -> mrb
zhl -> mtq
zhm -> jvf
zhn -> ldc
zho -> dmz
zhp -> zmv
zhq -> rpc
zhr -> bjl
zhs -> ubw
zht -> uzc
zhu -> chq
zhv -> ere
zhw -> loe
zhx -> paj
zhy -> bvr
zhz -> iza
zia -> yyp
zib -> sik
zic -> jin
zid -> ktx
zie -> vgw
zif -> mzp
zig -> nyr
zih -> zga
zii -> asn
zij -> bvk
zik -> dxu
zil -> uyj
zim -> rje
zin -> wkt
zio -> pyo
zip -> rag
ziq -> uzd
zir -> pml
zis -> pkn
zit -> kgd
ziu -> qhz
ziv -> nxo
ziw -> trs
zix -> wdf
ziy -> ims
ziz -> lrp
zja -> ohj
zjb -> kjv
zjc -> kdx
zjd -> nrb
zje -> eir
zjf -> fyx
zjg -> ifl
zjh -> wxr
zji -> sod
zjj -> vin
zjk -> hxa
zjl -> qqq
zjm -> zmz
zjn -> qrm
zjo -> pci
zjp -> uwo
zjq -> qhi
zjr -> zyk
zjs -> ztp
zjt -> acc
zju -> orv
zjv -> hok
zjw -> eaz
zjx -> czh
zjy -> cta
zjz -> aom
zka -> jjy
zkb -> ahw
zkc -> syz
zkd -> sqw
zke -> weg
zkf -> kwh
zkg -> fgy
zkh -> kux
zki -> zrz
zkj -> oan
zkk -> cdj
zkl -> oao
zkm -> vhp
zkn -> lfs
zko -> mgv
zkp -> lva
zkq -> nsp
zkr -> quf
zks -> gpn
zkt -> fat
zku -> lce
zkv -> rry
zkw -> xmc
zkx -> fra
zky -> pir
zkz -> uhk
zla -> fjg
zlb -> jou
zlc -> tdz
zld -> ovy
zle -> hrr
zlf -> mjn
zlg -> zjk
zlh -> lyd
zli -> gsj
zlj -> vcj
zlk -> giw
zll -> yib
zlm -> tkw
zln -> cvr
zlo -> rdk
zlp -> pdf
zlq -> xfl
zlr -> zck
zls -> ttk
zlt -> igw
zlu -> oub
zlv -> czw
zlw -> emm
zlx -> ibf
zly -> mxm
zlz -> vxz
zma -> flt
zmb -> kfj
zmc -> mst
zmd -> psi
zme -> mow
zmf -> zyq
zmg -> qyg
zmh -> jam
zmi -> rhq
zmj -> pay
zmk -> dki
zml -> ouq
zmm -> qyy
zmn -> avn
zmo -> glj
zmp -> ivi
zmq -> qxs
zmr -> xhl
zms -> buw
zmt -> yhc
zmu -> yhj
zmv -> rax
zmw -> iqx
zmx -> awh
zmy -> wtt
zmz -> bkd
zna -> cpq
znb -> mgr
znc -> qdf
znd -> gbi
zne -> bki
znf -> sfe
zng -> jwd
znh -> nno
zni -> hea
znj -> job
znk -> qzn
znl -> gcc
znm -> wre
znn -> mxl
zno -> tek
znp -> vgm
znq -> ejp
znr -> pbs
zns -> qsx
znt -> vju
znu -> eca
znv -> rql
znw -> xbi
znx -> ubt
zny -> gmh
znz -> zxz
zoa -> veu
zob -> mho
zoc -> wom
zod -> kgh
zoe -> kav
zof -> ers
zog -> mkv
zoh -> kan
zoi -> aad
zoj -> cyu
zok -> nxz
zol -> wpo
zom -> dmv
zon -> chw
zoo -> mth
zop -> csu
zoq -> wfw
zor -> ala
zos -> btm
zot -> zxv
zou -> klg
zov -> vdx
zow -> hak
zox -> wyp
zoy -> mpf
zoz -> zdz
zpa -> ske
zpb -> slk
zpc -> vnh
zpd -> uwn
zpe -> bdy
zpf -> bvu
zpg -> ugq
zph -> mzd
zpi -> ter
zpj -> utn
zpk -> sbn
zpl -> pli
zpm -> jgh
zpn -> nsj
zpo -> zaw
zpp -> hha
zpq -> cef
zpr -> rtv
zps -> vaz
zpt -> xeb
zpu -> dzo
zpv -> qwf
zpw -> dcj
zpx -> vcx
zpy -> zqh
zpz -> vpm
zqa -> zgn
zqb -> efl
zqc -> vmb
zqd -> ony
zqe -> yji
zqf -> rsb
zqg -> wrl
zqh -> gro
zqi -> zcp
zqj -> abp
zqk -> ngx
zql -> zkh
zqm -> shj
zqn -> gss
zqo -> arx
zqp -> hwi
zqq -> lkt
zqr -> ewk
zqs -> ubg
zqt -> fqk
zqu -> pdd
zqv -> fec
zqw -> bht
zqx -> eyi
zqy -> pvh
zqz -> cnd
zra -> oyb
zrb -> knr
zrc -> kpl
zrd -> tez
zre -> ozm
zrf -> vzw
zrg -> hks
zrh -> atx
zri -> bsx
zrj -> gsq
zrk -> gfl
zrl -> omq
zrm -> tmp
zrn -> dam
zro -> rzj
zrp -> rak
zrq -> nmr
zrr -> vxl
zrs -> maa
zrt -> lnv
zru -> asy
zrv -> qvo
zrw -> crr
zrx -> eye
zry -> kbn
zrz -> fhu
zsa -> goe
zsb -> pxz
zsc -> vdg
zsd -> gwj
zse -> hwh
zsf -> oiw
zsg -> ivl
zsh -> dmm
zsi -> lzr
zsj -> jkt
zsk -> vyw
zsl -> mci
zsm -> aay
zsn -> kir
zso -> rlm
zsp -> zoc
zsq -> lbj
zsr -> buc
zss -> qcd
zst -> rjt
zsu -> dtm
zsv -> zae
zsw -> jry
zsx -> stn
zsy -> ntx
zsz -> gyi
zta -> qtv
ztb -> yby
ztc -> ola
ztd -> egp
zte -> eof
ztf -> dry
ztg -> rqc
zth -> igt
zti -> ygv
ztj -> jix
ztk -> guw
ztl -> chx
ztm -> tux
ztn -> ygz
zto -> yet
ztp -> luk
ztq -> oms
ztr -> orr
zts -> els
ztt -> zbl
ztu -> upx
ztv -> kqr
ztw -> hdm
ztx -> xct
zty -> mjs
ztz -> hwo
zua -> did
zub -> ngk
zuc -> zlh
zud -> yyy
zue -> wvz
zuf -> mmg
zug -> uao
zuh -> zrj
zui -> til
zuj -> ozx
zuk -> njb
zul -> obj
zum -> jqq
zun -> roo
zuo -> zhf
zup -> sld
zuq -> bkc
zur -> xhz
zus -> cha
zut -> ihd
zuu -> ito
zuv -> lhl
zuw -> llb
zux -> ueb
zuy -> edb
zuz -> ogq
zva -> pmg
zvb -> tze
zvc -> tgc
zvd -> uzf
zve -> ndk
zvf -> rly
zvg -> mnr
zvh -> mhf
zvi -> lcy
zvj -> sab
zvk -> bbu
zvl -> fjc
zvm -> vas
zvn -> imc
zvo -> efc
zvp -> ybb
zvq -> oyv
zvr -> ngn
zvs -> pbg
zvt -> pwb
zvu -> xep
zvv -> mbq
zvw -> ijg
zvx -> kje
zvy -> nrz
zvz -> ubp
zwa -> ovz
zwb -> cwt
zwc -> skh
zwd -> bqn
zwe -> tmd
zwf -> kgx
zwg -> clt
zwh -> lnh
zwi -> lvt
zwj -> fzo
zwk -> jbk
zwl -> hlq
zwm -> njr
zwn -> ysn
zwo -> lmd
zwp -> www
zwq -> xhy
zwr -> nwk
zws -> fos
zwt -> nmg
zwu -> out
zwv -> wjn
zww -> ubu
zwx -> vub
zwy -> bqf
zwz -> ajf
zxa -> rka
zxb -> jyl
zxc -> wfh
zxd -> pwr
zxe -> zre
zxf -> lox
zxg -> uor
zxh -> qrp
zxi -> gdd
zxj -> qor
zxk -> nzm
zxl -> hkc
zxm -> mbc
zxn -> ntl
zxo -> exo
zxp -> ixb
zxq -> uyp
zxr -> lmx
zxs -> uar
zxt -> xqn
zxu -> jdz
zxv -> zsk
zxw -> zfy
zxx -> sum
zxy -> tpu
zxz -> sib
zya -> xqs
zyb -> rzh
zyc -> djv
zyd -> xck
zye -> xxc
zyf -> jrw
zyg -> gfm
zyh -> fvi
zyi -> uaf
zyj -> fme
zyk -> rdq
zyl -> mwm
zym -> yjb
zyn -> kmu
zyo -> tmr
zyp -> exf
zyq -> fvf
zyr -> ohz
zys -> qpg
zyt -> lht
zyu -> hzh
zyv -> mhp
zyw -> oqe
zyx -> etp
zyy -> soh
zyz -> qqs
zza -> eic
zzb -> ppf
zzc -> upu
zzd -> kex
zze -> fhr
zzf -> leo
zzg -> dvt
zzh -> oje
zzi -> cie
zzj -> kmb
zzk -> hne
zzl -> rns
zzm -> tly
zzn -> xlz
zzo -> wwm
zzp -> dlb
zzq -> imi
zzr -> uqi
zzs -> mza
zzt -> pnr
zzu -> plk
zzv -> bgo
zzw -> kln
zzx -> ura
zzy -> prf
zzz -> tfm
aa -> im
ab -> sb
ac -> em
ad -> ed
ae -> oo
af -> sh
ag -> fq
ah -> nn
ai -> sn
aj -> ch
ak -> kt
al -> pl
am -> qm
an -> gu
ao -> is
ap -> hb
aq -> uw
ar -> dt
as -> yh
at -> zu
au -> ji
av -> hl
aw -> mu
ax -> cv
ay -> yi
az -> aa
ba -> qt
bb -> fg
bc -> yc
bd -> nv
be -> yk
bf -> ty
bg -> bp
bh -> op
bi -> ke
bj -> um
bk -> qx
bl -> ek
bm -> yw
bn -> kd
bo -> qu
bp -> rp
bq -> hr
br -> xj
bs -> qi
bt -> ic
bu -> ga
bv -> od
bw -> bj
bx -> jn
by -> dv
bz -> ce
ca -> be
cb -> wg
cc -> yp
cd -> ig
ce -> lj
cf -> wc
cg -> bn
ch -> pb
ci -> yt
cj -> ya
ck -> tb
cl -> nh
cm -> ot
cn -> on
co -> zs
cp -> ok
cq -> kf
cr -> yo
cs -> fh
ct -> ux
cu -> ka
cv -> or
cw -> jr
cx -> hk
cy -> uk
cz -> nb
da -> nl
db -> ap
dc -> my
dd -> iy
de -> bw
df -> xl
dg -> kx
dh -> vf
di -> ly
dj -> zl
dk -> wk
dl -> nw
dm -> lk
dn -> bx
do -> kb
dp -> gy
dq -> ev
dr -> gn
ds -> qg
dt -> ug
du -> hu
dv -> ud
dw -> az
dx -> gq
dy -> ta
dz -> dr
ea -> vi
eb -> wj
ec -> nx
ed -> uf
ee -> rz
ef -> np
eg -> bq
eh -> fy
ei -> uc
ej -> xg
ek -> xc
el -> hs
em -> up
en -> jx
eo -> hg
ep -> se
eq -> rh
er -> cq
es -> dy
et -> gl
eu -> oq
ev -> ea
ew -> km
ex -> jc
ey -> hh
ez -> gx
fa -> bo
fb -> ef
fc -> qn
fd -> cb
fe -> xh
ff -> cd
fg -> yd
fh -> vl
fi -> eg
fj -> mc
fk -> rg
fl -> oh
fm -> bu
fn -> sm
fo -> vu
fp -> el
fq -> zy
fr -> nq
fs -> wh
ft -> uo
fu -> pg
fv -> dq
fw -> xx
fx -> eb
fy -> rr
fz -> io
ga -> jt
gb -> ti
gc -> if
gd -> ry
ge -> cw
gf -> xw
gg -> rn
gh -> rj
gi -> bf
gj -> vg
gk -> al
gl -> pm
gm -> go
gn -> eq
go -> th
gp -> jm
gq -> gt
gr -> wn
gs -> ex
gt -> pe
gu -> ad
gv -> xu
gw -> id
gx -> lt
gy -> sy
gz -> tf
ha -> ia
hb -> fi
hc -> vo
hd -> vc
he -> pu
hf -> rb
hg -> ir
hh -> dn
hi -> yz
hj -> nd
hk -> yb
hl -> qo
hm -> nt
hn -> ol
ho -> ep
hp -> zc
hq -> zx
hr -> pt
hs -> pi
ht -> mn
hu -> dw
hv -> hi
hw -> lq
hx -> lf
hy -> es
hz -> nc
ia -> pn
ib -> os
ic -> hz
id -> cy
ie -> cc
if -> jo
ig -> zo
ih -> bk
ii -> ts
ij -> oj
ik -> hn
il -> dh
im -> ii
in -> ll
io -> vq
ip -> nj
iq -> ca
ir -> ct
is -> mk
it -> au
iu -> ur
iv -> hf
iw -> tz
ix -> mr
iy -> qs
iz -> yv
ja -> oe
jb -> ml
jc -> xf
jd -> xy
je -> jk
jf -> ov
jg -> wt
jh -> rf
ji -> vk
jj -> en
jk -> cg
jl -> fl
jm -> og
jn -> ub
jo -> lv
jp -> lm
jq -> jg
jr -> rl
js -> vr
jt -> xr
ju -> kv
jv -> mm
jw -> kk
jx -> pd
jy -> fu
jz -> il
ka -> pv
kb -> ha
kc -> mj
kd -> dg
ke -> do
kf -> xz
kg -> lc
kh -> qq
ki -> iv
kj -> fw
kk -> ju
kl -> sd
km -> qh
kn -> rd
ko -> ae
kp -> ks
kq -> xm
kr -> gf
ks -> sz
kt -> xd
ku -> ez
kv -> wq
kw -> bs
kx -> cl
ky -> ou
kz -> ss
la -> xi
lb -> ag
lc -> hp
ld -> ff
le -> jy
lf -> ej
lg -> nk
lh -> zb
li -> fz
lj -> fx
lk -> us
ll -> oa
lm -> ai
ln -> vh
lo -> zq
lp -> uq
lq -> gs
lr -> ah
ls -> qy
lt -> vj
lu -> te
lv -> pz
lw -> ow
lx -> yx
ly -> sa
lz -> sl
ma -> yj
mb -> he
mc -> oi
md -> wi
me -> pr
mf -> ax
mg -> tq
mh -> rw
mi -> ro
mj -> rq
mk -> wp
ml -> ay
mm -> fe
mn -> aw
mo -> da
mp -> wx
mq -> bg
mr -> rk
ms -> pw
mt -> pq
mu -> je
mv -> gr
mw -> vm
mx -> md
my -> gg
mz -> lx
na -> xe
nb -> jf
nc -> js
nd -> hq
ne -> nu
nf -> ri
ng -> by
nh -> iz
ni -> td
nj -> it
nk -> ox
nl -> tk
nm -> kp
nn -> ib
no -> mx
np -> gw
nq -> et
nr -> gv
ns -> qw
nt -> sq
nu -> mi
nv -> bt
nw -> fm
nx -> bb
ny -> bh
nz -> xs
oa -> ph
ob -> cf
oc -> yn
od -> fr
oe -> jd
of -> mg
og -> ao
oh -> mh
oi -> bc
oj -> vb
ok -> kc
ol -> jb
om -> jp
on -> xt
oo -> cx
op -> ku
oq -> wu
or -> ns
os -> gb
ot -> yg
ou -> oc
ov -> kj
ow -> ru
ox -> ob
oy -> ew
oz -> ve
pa -> bl
pb -> of
pc -> hw
pd -> fp
pe -> yq
pf -> qc
pg -> to
ph -> cm
pi -> lp
pj -> zd
pk -> sw
pl -> zp
pm -> nz
pn -> fa
po -> rv
pp -> ql
pq -> fv
pr -> at
ps -> mw
pt -> zw
pu -> yy
pv -> xq
pw -> fn
px -> zg
py -> qf
pz -> ny
qa -> fs
qb -> in
qc -> dl
qd -> lb
qe -> ne
qf -> wf
qg -> fc
qh -> ck
qi -> ld
qj -> xb
qk -> gk
ql -> ei
qm -> rx
qn -> ps
qo -> qv
qp -> wb
qq -> ih
qr -> za
qs -> ra
qt -> qp
qu -> zz
qv -> yf
qw -> wd
qx -> sg
qy -> zj
qz -> ds
ra -> ho
rb -> nr
rc -> vn
rd -> pf
re -> wm
rf -> om
rg -> uz
rh -> ec
ri -> va
rj -> jw
rk -> cu
rl -> so
rm -> uv
rn -> fj
ro -> dd
rp -> fd
rq -> we
rr -> uy
rs -> st
rt -> zt
ru -> ar
rv -> cn
rw -> tj
rx -> tr
ry -> fo
rz -> wo
sa -> bm
sb -> dk
sc -> nf
sd -> lu
se -> ng
sf -> dz
sg -> sr
sh -> xn
si -> db
sj -> tv
sk -> un
sl -> mb
sm -> ui
sn -> rs
so -> dc
sp -> kq
sq -> ws
sr -> hd
ss -> lh
st -> sx
su -> ge
sv -> bz
sw -> hv
sx -> oz
sy -> ip
sz -> vp
ta -> bv
tb -> lr
tc -> iu
td -> cs
te -> hc
tf -> kr
tg -> ja
th -> ue
ti -> ik
tj -> gz
tk -> oy
tl -> la
tm -> ms
tn -> xo
to -> vz
tp -> pa
tq -> tu
tr -> sp
ts -> si
tt -> py
tu -> wz
tv -> mp
tw -> kz
tx -> xp
ty -> an
tz -> di
ua -> tt
ub -> ky
uc -> ko
ud -> co
ue -> jj
uf -> su
ug -> iq
uh -> ls
ui -> ey
uj -> xv
uk -> tw
ul -> cr
um -> kn
un -> ww
uo -> kg
up -> dx
uq -> yu
ur -> wv
us -> ul
ut -> yl
uu -> ut
uv -> jl
uw -> mq
ux -> po
uy -> qz
uz -> lg
va -> bi
vb -> re
vc -> vt
vd -> wr
ve -> ze
vf -> mz
vg -> rc
vh -> px
vi -> xk
vj -> pc
vk -> mf
vl -> ki
vm -> cp
vn -> vx
vo -> zh
vp -> qe
vq -> pp
vr -> ys
vs -> zn
vt -> gi
vu -> qb
vv -> aq
vw -> eo
vx -> aj
vy -> jv
vz -> uj
wa -> pj
wb -> er
wc -> af
wd -> ym
we -> li
wf -> wy
wg -> lw
wh -> dm
wi -> jz
wj -> zi
wk -> br
wl -> eh
wm -> cj
wn -> cz
wo -> vs
wp -> qa
wq -> qd
wr -> kw
ws -> bd
wt -> gh
wu -> sf
wv -> ac
ww -> vw
wx -> sj
wy -> tm
wz -> ua
xa -> tn
xb -> sv
xc -> uu
xd -> gj
xe -> gd
xf -> tx
xg -> lo
xh -> pk
xi -> iw
xj -> uh
xk -> sc
xl -> ye
xm -> eu
xn -> sk
xo -> ij
xp -> rm
xq -> as
xr -> zv
xs -> ni
xt -> hm
xu -> lz
xv -> yr
xw -> vy
xx -> vv
xy -> kl
xz -> ba
ya -> tp
yb -> no
yc -> qr
yd -> ab
ye -> dp
yf -> mt
yg -> gm
yh -> wa
yi -> tc
yj -> rt
yk -> le
yl -> ak
ym -> zk
yn -> me
yo -> gc
yp -> ci
yq -> gp
yr -> hy
ys -> tl
yt -> kh
yu -> tg
yv -> vd
yw -> av
yx -> hx
yy -> zr
yz -> zf
za -> dj
zb -> xa
zc -> ix
zd -> am
ze -> nm
zf -> ie
zg -> jh
zh -> wl
zi -> mv
zj -> ee
zk -> fk
zl -> qj
zm -> hj
zn -> zm
zo -> fb
zp -> du
zq -> ma
zr -> jq
zs -> ht
zt -> ln
zu -> df
zv -> qk
zw -> de
zx -> ft
zy -> na
zz -> mo
a -> c
b -> m
c -> p
d -> a
e -> i
f -> b
g -> n
h -> x
i -> h
j -> d
k -> z
l -> o
m -> e
n -> r
o -> u
p -> s
q -> l
r -> v
s -> t
t -> f
u -> w
v -> q
w -> k
x -> y
y -> j
z -> g
